"","VTDKEY","Biden","Trump","Voter_Registration","Turnout","VTD","vap","anglovap","nanglovap"
"1",1,357,791,1847,1164,"0001",2340,1347,993
"2",2,205,1548,2652,1769,"0002",2880,2453,427
"3",3,118,746,1203,873,"0003",1473,1151,322
"4",4,117,1031,1586,1156,"0004",1821,1605,216
"5",5,12,203,290,215,"0005",325,274,51
"6",6,389,388,1465,783,"0006",1588,656,932
"7",7,462,167,1398,632,"0007",2048,379,1669
"8",8,92,75,326,171,"0008",735,256,479
"9",9,160,737,1394,902,"0009",1612,1194,418
"10",10,42,327,578,371,"0010",6772,2529,4243
"11",11,202,643,1311,854,"0011",8373,3078,5295
"12",12,316,785,1800,1110,"0013",2276,1399,877
"13",13,79,578,932,661,"0015",1072,851,221
"14",14,106,519,865,631,"0016",915,718,197
"15",15,127,489,861,623,"0017",1082,698,384
"16",16,215,1211,2126,1438,"0018",2249,1840,409
"17",17,346,1118,2308,1481,"0019",2580,1628,952
"18",18,180,551,1190,745,"0020",1539,853,686
"19",19,183,1086,1872,1274,"0021",2169,1717,452
"20",20,105,640,1024,750,"0022",1150,944,206
"21",21,99,876,1334,978,"0023",1395,1236,159
"22",22,43,601,862,648,"0024",987,861,126
"23",23,184,1131,2461,1330,"0001",3570,1407,2163
"24",24,207,1499,2743,1735,"0002",3558,1980,1578
"25",25,230,1252,2567,1500,"0003",2940,1264,1676
"26",26,228,1055,2481,1302,"0004",2880,985,1895
"27",27,121,163,579,284,"0001",891,317,574
"28",28,996,349,2624,1367,"0002",3827,792,3035
"29",29,219,968,1879,1203,"0003",2942,2070,872
"30",30,424,702,2016,1153,"0004",1323,551,772
"31",31,465,607,2006,1099,"0005",2649,1216,1433
"32",32,91,343,623,439,"0006",928,664,264
"33",33,122,914,1380,1056,"0007",1347,1151,196
"34",34,68,513,761,592,"0008A",1262,1105,157
"35",35,70,152,298,227,"0008B",851,691,160
"36",36,344,368,1205,724,"0009",297,231,66
"37",37,48,53,167,101,"0010A",1615,697,918
"38",38,160,1485,2188,1663,"0010B",233,49,184
"39",39,100,477,890,586,"0011",2381,2062,319
"40",40,200,219,716,435,"0012",1208,865,343
"41",41,443,892,1938,1360,"0013",885,407,478
"42",42,73,400,691,481,"0014",2268,1419,849
"43",43,561,641,2255,1231,"0015",1300,770,530
"44",44,113,1075,1592,1199,"0016",3308,1089,2219
"45",45,144,313,725,464,"0017",1891,1737,154
"46",46,355,700,1423,1083,"0018",1007,575,432
"47",47,1129,215,2832,1363,"0019",1535,1022,513
"48",48,128,377,741,510,"0020",3892,532,3360
"49",49,159,1161,1874,1338,"0021",2121,1239,882
"50",50,45,340,510,394,"0022",652,532,120
"51",51,345,1308,2719,1679,"0023",600,560,40
"52",52,244,1291,2389,1558,"0024",3395,2108,1287
"53",53,153,1085,1620,1245,"0025",2720,2020,700
"54",54,21,255,356,284,"0026",1788,1526,262
"55",55,134,700,1160,847,"0027",433,352,81
"56",56,132,949,1569,1094,"0028A",1092,827,265
"57",57,63,687,1089,758,"0028B",135,71,64
"58",58,58,224,480,288,"0029",1665,1450,215
"59",59,0,19,27,20,"0030",1167,1094,73
"60",60,73,1026,1539,1109,"0031",515,288,227
"61",61,467,1092,2280,1594,"0032",415,370,45
"62",62,343,1017,1898,1380,"0033",948,874,74
"63",63,59,304,536,373,"0034",2722,1901,821
"64",64,49,241,437,292,"0035",1963,1407,556
"65",65,108,233,552,348,"0036",16,14,2
"66",66,182,300,757,485,"0037",592,422,170
"67",67,116,622,1290,750,"0038",507,357,150
"68",68,18,296,488,317,"0039",758,488,270
"69",69,319,1317,2422,1653,"0040",1102,567,535
"70",70,664,1637,3944,2327,"011B",1482,1238,244
"71",71,843,2406,4567,3290,"017B",430,387,43
"72",72,687,2307,4202,3027,"0001",2587,2035,552
"73",73,215,888,1962,1108,"0002",4461,2391,2070
"74",74,188,684,1162,885,"0003",4961,3729,1232
"75",75,89,905,1437,1013,"0004",4188,3307,881
"76",76,59,570,813,637,"001A",2431,1519,912
"77",77,26,257,385,287,"004A",1188,954,234
"78",78,28,500,674,532,"0001",1434,1299,135
"79",79,14,129,184,147,"0002",1076,964,112
"80",80,79,753,1202,847,"0003",400,328,72
"81",81,11,141,229,153,"0004",681,524,157
"82",82,33,228,343,266,"0005",136,121,15
"83",83,10,113,157,125,"0006",1228,1079,149
"84",84,79,533,815,623,"0007",224,194,30
"85",85,2,16,29,18,"0008",307,281,26
"86",86,6,51,87,57,"0009",196,185,11
"87",87,10,104,147,115,"0010",821,736,85
"88",88,14,272,386,291,"0011",109,100,9
"89",89,15,152,248,171,"0101",360,319,41
"90",90,10,61,91,71,"0201",257,215,42
"91",91,14,240,331,254,"0202",101,92,9
"92",92,6,37,58,43,"0301",258,230,28
"93",93,6,115,156,123,"0303",53,47,6
"94",94,10,135,191,147,"0401",191,164,27
"95",95,0,23,30,23,"0402",177,161,16
"96",96,140,451,895,599,"0404",30,30,0
"97",97,279,567,1512,860,"0001",1041,466,575
"98",98,208,290,964,506,"0002",2377,457,1920
"99",99,364,486,1628,862,"0003",2457,981,1476
"100",100,89,117,393,210,"0004",160,66,94
"101",101,343,670,1873,1033,"0005",2942,738,2204
"102",102,122,259,555,391,"0006",124,93,31
"103",103,531,782,2403,1330,"0007",2528,737,1791
"104",104,122,212,515,337,"0008",681,272,409
"105",105,457,754,1785,1235,"0009",180,139,41
"106",106,274,504,1327,794,"0010",1974,594,1380
"107",107,440,1229,2660,1696,"0011",65,40,25
"108",108,39,107,204,149,"0012",1679,499,1180
"109",109,606,949,2775,1588,"0013",3080,1394,1686
"110",110,614,561,2216,1204,"0014",473,199,274
"111",111,334,746,1752,1097,"0015",2334,723,1611
"112",112,75,251,493,329,"0016",306,115,191
"113",113,622,2106,3685,2778,"0017",2360,412,1948
"114",114,115,582,977,712,"0018",1905,567,1338
"115",115,102,416,734,523,"0019",517,238,279
"116",116,187,751,1405,947,"0020",4229,2462,1767
"117",117,217,808,1390,1036,"0021",278,193,85
"118",118,161,974,1442,1153,"0022",742,416,326
"119",119,97,512,824,614,"0023",1502,388,1114
"120",120,379,1638,2725,2039,"0024",2049,717,1332
"121",121,162,904,1324,1075,"0101",1677,1047,630
"122",122,87,477,731,565,"0102",1455,965,490
"123",123,103,401,620,505,"0103",1577,1250,327
"124",124,40,451,607,496,"0104",938,631,307
"125",125,436,1507,2863,1975,"0205",2309,1686,623
"126",126,307,356,1194,676,"0206",607,462,145
"127",127,136,310,668,449,"0207",361,316,45
"128",128,166,903,1466,1089,"0208",731,635,96
"129",129,216,699,1400,922,"0209",662,546,116
"130",130,257,756,1584,1019,"0210",780,629,151
"131",131,114,440,976,560,"0211",380,328,52
"132",132,101,607,1108,711,"0312",674,552,122
"133",133,104,255,818,365,"0313",1732,488,1244
"134",134,80,111,527,193,"0314",3272,2038,1234
"135",135,10,21,104,31,"0415",1763,1004,759
"136",136,260,1009,1757,1281,"0416",1766,916,850
"137",137,397,1684,2743,2111,"0417",721,426,295
"138",138,407,1321,2361,1745,"0418",1752,1204,548
"139",139,324,968,1770,1305,"0001",1155,508,647
"140",140,366,1651,2832,2045,"0002",1307,731,576
"141",141,142,971,1514,1127,"0003",1196,341,855
"142",142,328,1506,2365,1860,"0004A",1033,105,928
"143",143,67,165,286,238,"0004B",147,97,50
"144",144,133,441,913,579,"0101",1993,1563,430
"145",145,81,341,524,425,"0102",2594,2040,554
"146",146,108,175,371,293,"0203",2469,1911,558
"147",147,179,296,611,485,"0204",1944,1452,492
"148",148,672,1099,2287,1815,"0305",2718,2073,645
"149",149,722,645,2056,1392,"0306",1397,1181,216
"150",150,369,507,1192,896,"0407",2484,1877,607
"151",151,721,823,2723,1596,"0408",230,199,31
"152",152,566,705,1700,1304,"0409",1049,683,366
"153",153,413,508,1230,945,"0410",471,416,55
"154",154,702,809,2286,1563,"1001",3715,2711,1004
"155",155,204,346,783,564,"1002",2931,1635,1296
"156",156,504,728,1672,1267,"1003",3914,2430,1484
"157",157,335,638,1330,997,"1004",6131,2231,3900
"158",158,841,1352,2991,2246,"1022",4322,2754,1568
"159",159,703,1472,2977,2224,"2005",3375,2311,1064
"160",160,850,1207,3010,2101,"2006",1909,1434,475
"161",161,525,1463,2591,2024,"2007",2599,2023,576
"162",162,692,1195,2629,1946,"2008",1111,888,223
"163",163,346,801,1562,1184,"2009",2292,1458,834
"164",164,843,804,2663,1682,"2010",1955,1250,705
"165",165,1034,701,2936,1777,"2011",2936,2086,850
"166",166,883,1042,2799,1985,"3012",1263,835,428
"167",167,761,758,2283,1567,"3013",1932,1289,643
"168",168,306,563,1264,897,"3014",4919,1640,3279
"169",169,532,652,1737,1218,"3015",6811,1331,5480
"170",170,828,647,2205,1516,"3016",4224,2087,2137
"171",171,835,580,2060,1463,"4017",3849,1666,2183
"172",172,40,428,631,475,"4018",1141,736,405
"173",173,42,382,599,430,"4019",3709,1982,1727
"174",174,48,335,597,391,"4020",5783,2237,3546
"175",175,53,349,577,407,"4021",2206,1272,934
"176",176,449,837,2215,1303,"0001",679,600,79
"177",177,55,306,549,364,"0002",602,460,142
"178",178,335,638,1821,995,"0003",632,522,110
"179",179,108,292,622,402,"0004",723,630,93
"180",180,137,448,967,589,"0001",2467,898,1569
"181",181,208,524,1272,736,"0002",222,134,88
"182",182,255,192,751,454,"0003",9616,2046,7570
"183",183,385,333,1579,730,"0004",394,225,169
"184",184,346,646,1590,1005,"0005",403,210,193
"185",185,226,453,1073,691,"0006",1250,537,713
"186",186,302,378,1182,694,"0008",210,124,86
"187",187,297,837,1687,1144,"0009",768,72,696
"188",188,184,122,669,312,"0010",1987,338,1649
"189",189,986,2470,5004,3537,"0011",286,106,180
"190",190,851,2105,4307,3029,"0012",262,159,103
"191",191,905,1811,4652,2779,"0013",1586,577,1009
"192",192,706,1914,3693,2681,"0014",262,90,172
"193",193,187,993,1711,1199,"0016",1336,474,862
"194",194,1447,740,4458,2264,"0017",1377,341,1036
"195",195,92,254,597,348,"0018",1876,905,971
"196",196,192,1043,1721,1253,"0019",720,108,612
"197",197,845,548,3166,1434,"0101",10676,7167,3509
"198",198,436,470,3314,949,"0102",4433,2947,1486
"199",199,828,1258,3322,2128,"0103",9507,4990,4517
"200",200,754,1735,3966,2547,"0104",8454,6462,1992
"201",201,843,1252,3316,2136,"0105",1958,1501,457
"202",202,873,2365,4544,3312,"0106",7838,2272,5566
"203",203,552,282,1700,867,"0107",804,439,365
"204",204,0,0,0,0,"0108",1870,1469,401
"205",205,851,794,3284,1686,"0109",4096,1236,2860
"206",206,1292,1559,4781,2927,"0110",8149,4191,3958
"207",207,594,2208,3556,2859,"0111",8002,4378,3624
"208",208,603,396,2312,1024,"0113",377,300,77
"209",209,1707,882,5225,2649,"0201",6056,2597,3459
"210",210,955,524,2731,1517,"0202",8699,4251,4448
"211",211,1299,701,4114,2065,"0203",7582,6187,1395
"212",212,1815,984,4964,2860,"0204",5194,1675,3519
"213",213,1565,1270,4538,2929,"0205",6931,1870,5061
"214",214,1516,978,4076,2537,"0206",2309,714,1595
"215",215,305,208,1165,520,"0207",6056,1777,4279
"216",216,429,345,1246,801,"0208",8247,2461,5786
"217",217,697,2581,4153,3342,"0209",9154,3778,5376
"218",218,1690,1163,4658,2927,"0210",8570,2701,5869
"219",219,1757,1155,4923,2997,"0301",4626,3471,1155
"220",220,989,1131,3703,2176,"0302",6024,3506,2518
"221",221,446,2238,3982,2741,"0303",6542,3402,3140
"222",222,1232,1734,4971,3047,"0304",1002,655,347
"223",223,1341,1503,4899,2915,"0305",3349,2295,1054
"224",224,57,171,331,233,"0306",4742,1803,2939
"225",225,509,1000,2257,1545,"0307",5303,1429,3874
"226",226,1011,776,3790,1827,"0308",4388,2131,2257
"227",227,1062,458,3591,1554,"0309",889,752,137
"228",228,1130,1520,4281,2734,"0310",574,473,101
"229",229,165,785,1335,965,"0311",3546,2771,775
"230",230,43,361,522,408,"0312",2451,1758,693
"231",231,409,1817,3115,2257,"0313",3514,2473,1041
"232",232,245,1223,2161,1484,"0314",5321,2767,2554
"233",233,1080,2029,4495,3186,"0315",9330,5715,3615
"234",234,837,964,3375,1839,"0317",8984,5801,3183
"235",235,866,1571,3645,2515,"0401",1795,1161,634
"236",236,1214,2145,4815,3446,"0402",2861,1884,977
"237",237,1112,1998,4633,3203,"0404",7138,2029,5109
"238",238,779,935,2934,1770,"0405",9120,2481,6639
"239",239,1508,1293,4725,2865,"0406",5619,1875,3744
"240",240,1488,765,4830,2325,"0408",9962,2565,7397
"241",241,1715,717,5209,2507,"0409",2492,923,1569
"242",242,883,639,3620,1562,"0410",6397,1669,4728
"243",243,1587,852,4900,2499,"0412",8705,1902,6803
"244",244,732,628,2173,1392,"0413",12527,3070,9457
"245",245,741,421,3601,1198,"1001",891,307,584
"246",246,1362,526,4098,1938,"1002",777,141,636
"247",247,1613,778,4469,2442,"1003",2888,669,2219
"248",248,1672,658,4950,2402,"1004",1335,86,1249
"249",249,1340,721,4197,2115,"1005",1182,62,1120
"250",250,274,548,1162,842,"1006",3089,153,2936
"251",251,420,108,794,544,"1007",1616,76,1540
"252",252,307,160,685,478,"1008",2167,685,1482
"253",253,1108,269,2263,1402,"1009",2077,538,1539
"254",254,370,110,940,486,"1010",765,121,644
"255",255,344,100,857,457,"1011",801,46,755
"256",256,861,297,2185,1175,"1012",3115,417,2698
"257",257,592,185,1309,784,"1013",3297,123,3174
"258",258,1076,209,1934,1305,"1014",1948,67,1881
"259",259,694,474,1770,1198,"1015",1977,59,1918
"260",260,320,74,641,405,"1016",1514,59,1455
"261",261,412,155,1179,583,"1017",385,95,290
"262",262,800,432,2289,1251,"1018",3516,237,3279
"263",263,1055,263,2541,1343,"1019",1646,189,1457
"264",264,517,127,1436,655,"1020",3128,295,2833
"265",265,553,167,1486,733,"1021",2240,145,2095
"266",266,446,139,1254,604,"1022",1231,34,1197
"267",267,96,49,264,148,"1023",3381,96,3285
"268",268,350,129,1003,488,"1024",3811,698,3113
"269",269,306,109,929,426,"1025",1005,53,952
"270",270,679,242,1726,932,"1026",1821,83,1738
"271",271,661,221,1744,910,"1027",554,118,436
"272",272,367,123,985,499,"1028",1368,84,1284
"273",273,943,264,2673,1227,"1029",2761,107,2654
"274",274,1301,719,3230,2067,"1030A",290,34,256
"275",275,223,68,770,299,"1030B",0,0,0
"276",276,452,166,1344,632,"1031",2290,118,2172
"277",277,175,127,434,309,"1032",3157,107,3050
"278",278,290,112,787,415,"1033",3375,504,2871
"279",279,803,247,2019,1070,"1034",4875,1716,3159
"280",280,23,16,81,43,"1035",9174,5171,4003
"281",281,589,179,1577,789,"1036",4779,718,4061
"282",282,902,232,2520,1164,"1037",4234,528,3706
"283",283,656,357,2228,1033,"1038",4499,537,3962
"284",284,1706,1375,4352,3156,"1039",5413,304,5109
"285",285,220,227,1148,474,"1040",3979,170,3809
"286",286,1334,764,3729,2137,"1041",3108,145,2963
"287",287,907,366,2648,1303,"1042",1277,42,1235
"288",288,1203,625,3254,1876,"1043",2088,252,1836
"289",289,1021,349,3350,1407,"1044",2420,116,2304
"290",290,951,303,2830,1278,"1045",5349,377,4972
"291",291,796,254,2430,1074,"1046",2996,220,2776
"292",292,445,171,1213,629,"1047",2383,162,2221
"293",293,609,301,1620,931,"1048",2918,255,2663
"294",294,915,331,2127,1269,"1049",3916,318,3598
"295",295,1345,535,3427,1921,"1050",1805,241,1564
"296",296,822,292,2127,1146,"1051",2834,460,2374
"297",297,650,229,1796,905,"1052",2641,317,2324
"298",298,869,347,2309,1240,"1053",345,42,303
"299",299,960,396,2673,1379,"1054",3222,384,2838
"300",300,330,154,860,495,"1055",2289,526,1763
"301",301,694,420,2140,1141,"1056",4766,442,4324
"302",302,861,380,2124,1257,"1057",4155,873,3282
"303",303,88,40,260,129,"1058",3869,791,3078
"304",304,1034,461,2592,1532,"1059",1267,140,1127
"305",305,897,487,2038,1414,"1060",4147,138,4009
"306",306,1180,731,3312,1955,"1061",4308,248,4060
"307",307,644,700,2544,1365,"1062",306,54,252
"308",308,783,721,2814,1526,"1063",3002,624,2378
"309",309,152,91,503,246,"1064A",1883,302,1581
"310",310,1155,428,3033,1618,"1064B",0,0,0
"311",311,979,337,2817,1349,"1065",3259,595,2664
"312",312,34,63,192,100,"1066",1294,168,1126
"313",313,562,645,2340,1229,"1067",4572,1147,3425
"314",314,401,311,1313,723,"1068",3564,733,2831
"315",315,714,709,2429,1442,"1069",859,295,564
"316",316,270,177,857,453,"1070",1840,271,1569
"317",317,878,1095,3265,2002,"1071",2480,477,2003
"318",318,701,576,2159,1312,"1072",2611,471,2140
"319",319,199,181,490,386,"1073",4065,1187,2878
"320",320,415,192,1227,620,"1074",37,3,34
"321",321,783,418,2024,1218,"1075",4260,413,3847
"322",322,884,341,2165,1248,"1076",3835,690,3145
"323",323,1411,1028,3759,2497,"1077",2114,93,2021
"324",324,6,5,24,11,"1078",657,18,639
"325",325,823,318,2428,1166,"1079",3603,797,2806
"326",326,1155,616,2994,1803,"1080",8523,1653,6870
"327",327,696,221,1688,942,"1081",3252,1870,1382
"328",328,210,61,517,275,"1082",6183,1132,5051
"329",329,1146,551,2711,1739,"1083",3027,820,2207
"330",330,1389,538,3324,1973,"1084",3270,355,2915
"331",331,529,760,1901,1315,"1085",2934,390,2544
"332",332,1214,649,3185,1916,"1086",3137,508,2629
"333",333,1177,704,2783,1924,"1087",2624,262,2362
"334",334,761,320,2143,1103,"1088",1241,44,1197
"335",335,635,270,1811,930,"1089",2061,360,1701
"336",336,1012,473,2507,1507,"1090",0,0,0
"337",337,635,250,1711,903,"1091",3023,241,2782
"338",338,352,115,1025,485,"1092",1736,100,1636
"339",339,24,7,59,31,"1093",2460,738,1722
"340",340,0,0,0,0,"1094",3932,583,3349
"341",341,969,451,2319,1442,"1095",637,343,294
"342",342,420,212,1194,646,"1096",248,35,213
"343",343,529,295,1230,843,"1097",1137,59,1078
"344",344,991,562,2598,1583,"1098",1195,75,1120
"345",345,95,72,370,173,"1099",3319,740,2579
"346",346,58,15,142,76,"1100",3243,711,2532
"347",347,289,125,853,429,"1101",1,0,1
"348",348,387,84,913,476,"1102",1594,407,1187
"349",349,1299,676,2918,2020,"1103",1352,453,899
"350",350,1210,665,2892,1906,"1104",4108,912,3196
"351",351,0,0,0,0,"1105",1775,212,1563
"352",352,291,324,1052,626,"1106",0,0,0
"353",353,288,275,850,577,"1107",4840,866,3974
"354",354,1375,804,3279,2239,"1108",5048,1616,3432
"355",355,262,158,756,429,"1109",19,0,19
"356",356,0,0,0,0,"1110",4073,949,3124
"357",357,943,785,3210,1771,"1111",5488,1298,4190
"358",358,786,556,1971,1370,"1112",6963,1048,5915
"359",359,0,3,3,3,"1113",4117,1234,2883
"360",360,1236,731,3057,2008,"1114",183,10,173
"361",361,1631,965,3747,2642,"1115",284,96,188
"362",362,1037,460,2475,1537,"1116",1675,573,1102
"363",363,1275,686,3135,2021,"1117",497,35,462
"364",364,23,18,49,41,"1118",5157,1581,3576
"365",365,472,170,1189,660,"1119",228,12,216
"366",366,513,444,1379,970,"1120",255,12,243
"367",367,123,78,366,204,"1121",4000,1245,2755
"368",368,1288,1091,3178,2438,"1122",5356,1736,3620
"369",369,56,19,146,76,"1123",960,251,709
"370",370,70,17,164,88,"1124",1258,121,1137
"371",371,1500,930,3532,2490,"1125",2417,778,1639
"372",372,1198,870,2837,2105,"1126",0,0,0
"373",373,59,41,137,101,"1127",814,42,772
"374",374,168,183,620,353,"1128",4347,977,3370
"375",375,88,35,234,124,"1129",2491,755,1736
"376",376,880,672,2190,1577,"1130",2,0,2
"377",377,0,0,0,0,"1131",0,0,0
"378",378,210,84,631,300,"1132",0,0,0
"379",379,606,402,1670,1029,"1133",49,6,43
"380",380,1068,656,2189,1756,"1134",5,1,4
"381",381,0,0,0,0,"1135",5,0,5
"382",382,0,0,0,0,"1136",334,66,268
"383",383,214,97,557,316,"1137",0,0,0
"384",384,0,2,4,2,"1138",2578,645,1933
"385",385,0,0,0,0,"1139",1236,214,1022
"386",386,0,0,1,0,"1140",1572,355,1217
"387",387,40,27,143,69,"1141",3289,803,2486
"388",388,0,0,0,0,"1142",2954,418,2536
"389",389,373,157,1042,539,"1143",4456,1544,2912
"390",390,804,337,1842,1166,"1144",2454,1851,603
"391",391,495,316,1278,829,"1145",727,330,397
"392",392,955,666,2400,1662,"1146",313,64,249
"393",393,875,402,2227,1307,"1147",3128,667,2461
"394",394,1404,1035,3559,2495,"1148",1453,266,1187
"395",395,958,1302,2615,2296,"1149",3087,667,2420
"396",396,251,294,736,548,"1150",3235,816,2419
"397",397,51,56,180,108,"1151",3024,940,2084
"398",398,1115,615,2696,1769,"2001",1451,139,1312
"399",399,340,195,920,553,"2002",1659,72,1587
"400",400,981,495,2262,1512,"2003",3408,119,3289
"401",401,1046,691,2642,1769,"2004",4438,220,4218
"402",402,1002,702,2370,1740,"2005",1309,171,1138
"403",403,577,338,1321,931,"2006",71,9,62
"404",404,448,374,1103,843,"2007",2628,92,2536
"405",405,783,571,1847,1375,"2008",1712,95,1617
"406",406,7,4,16,11,"2009",4607,1152,3455
"407",407,11,7,26,19,"2010",3084,687,2397
"408",408,609,323,1603,960,"2011",2661,199,2462
"409",409,1120,787,2816,1948,"2012",2230,69,2161
"410",410,1024,452,2441,1514,"2013",1620,94,1526
"411",411,371,141,875,522,"2014",1632,133,1499
"412",412,121,46,346,174,"2015",2652,75,2577
"413",413,284,76,954,365,"2016",1889,55,1834
"414",414,480,145,1245,631,"2017",1731,38,1693
"415",415,731,198,2161,943,"2018",1369,57,1312
"416",416,1072,296,2984,1403,"2019",2424,89,2335
"417",417,456,123,921,594,"2020",4614,166,4448
"418",418,9,2,22,11,"2021",3927,117,3810
"419",419,617,188,1726,825,"2022",2113,94,2019
"420",420,413,132,1117,562,"2023",2976,309,2667
"421",421,892,320,2358,1236,"2024",2986,254,2732
"422",422,536,323,1608,879,"2025",3276,328,2948
"423",423,735,194,2071,952,"2026",2813,580,2233
"424",424,542,155,1597,708,"2027",1672,288,1384
"425",425,533,153,1213,706,"2028",2733,602,2131
"426",426,502,172,1231,682,"2029",1954,43,1911
"427",427,642,188,1939,853,"2030",2028,73,1955
"428",428,459,91,1330,563,"2031",2520,74,2446
"429",429,365,101,1201,478,"2032",805,21,784
"430",430,559,168,1147,739,"2033",4034,678,3356
"431",431,647,157,1829,822,"2034",2630,919,1711
"432",432,1075,243,2930,1351,"2035",1425,664,761
"433",433,1052,305,2874,1396,"2036",1624,978,646
"434",434,582,169,1606,759,"2037",1571,643,928
"435",435,1113,331,2766,1481,"2038",1587,501,1086
"436",436,706,292,1904,1027,"2039A",1755,233,1522
"437",437,1174,383,2506,1592,"2039B",1,1,0
"438",438,1015,451,2208,1491,"2040",3745,601,3144
"439",439,603,272,1262,894,"2041",3354,216,3138
"440",440,1107,450,2275,1579,"2042",2246,105,2141
"441",441,419,123,1315,557,"2043",3160,106,3054
"442",442,550,150,1528,714,"2044",3677,157,3520
"443",443,563,146,1694,724,"2045",2199,557,1642
"444",444,228,66,538,300,"2046",2248,401,1847
"445",445,277,79,1423,366,"2047",2051,308,1743
"446",446,285,93,1628,396,"2048",2760,208,2552
"447",447,773,220,1391,1004,"2049",4214,455,3759
"448",448,894,357,1562,1278,"2050",2347,417,1930
"449",449,576,521,1552,1124,"2051",1226,406,820
"450",450,600,335,1261,954,"2052",1561,117,1444
"451",451,727,173,1409,921,"2053",1576,207,1369
"452",452,1032,438,2574,1504,"2054",2465,693,1772
"453",453,1200,461,2851,1689,"2055",2946,1780,1166
"454",454,660,206,1768,890,"2056",1878,240,1638
"455",455,796,260,2300,1085,"2057",3467,252,3215
"456",456,812,291,2655,1130,"2058",3268,345,2923
"457",457,650,168,1182,838,"2059",3775,459,3316
"458",458,975,369,1880,1369,"2060",2191,344,1847
"459",459,817,300,1646,1138,"2061",1563,388,1175
"460",460,706,226,1809,956,"2062",1374,289,1085
"461",461,1227,489,3082,1752,"2063",1894,1017,877
"462",462,828,348,1824,1192,"2064",3073,626,2447
"463",463,303,107,728,417,"2065",6797,1536,5261
"464",464,372,153,1023,538,"2066",3697,1472,2225
"465",465,545,156,1281,718,"2067",326,58,268
"466",466,1040,262,2002,1323,"2068",4424,1558,2866
"467",467,880,244,1920,1159,"2069",4761,801,3960
"468",468,603,233,1439,853,"2070",2841,88,2753
"469",469,897,304,2353,1228,"2071",1252,32,1220
"470",470,888,359,2290,1280,"2072",3667,1039,2628
"471",471,904,364,2360,1298,"2073",1772,268,1504
"472",472,640,244,1520,895,"2074",1463,71,1392
"473",473,500,277,1166,797,"2075",1700,48,1652
"474",474,536,271,1188,824,"2076",2629,913,1716
"475",475,641,903,1918,1574,"2077",2553,850,1703
"476",476,995,542,2379,1565,"2078",3249,686,2563
"477",477,795,438,1869,1257,"2079",1049,33,1016
"478",478,47,26,113,75,"2080",2004,306,1698
"479",479,1533,1296,3763,2883,"2081",1105,165,940
"480",480,144,35,269,181,"2082",2557,346,2211
"481",481,1658,1269,4174,2981,"2083",856,186,670
"482",482,1283,658,3153,1973,"2084",3483,1696,1787
"483",483,771,177,2152,971,"2085",1978,276,1702
"484",484,262,93,904,365,"2086",3892,1251,2641
"485",485,1285,905,3274,2252,"2087",1881,686,1195
"486",486,475,229,1258,719,"2088",4575,1183,3392
"487",487,392,120,1156,521,"2089",744,23,721
"488",488,412,89,1142,512,"2090",3688,881,2807
"489",489,984,719,2466,1749,"2091",4744,1326,3418
"490",490,1009,688,2396,1735,"2092",792,224,568
"491",491,1044,590,2680,1670,"2093",2975,799,2176
"492",492,251,41,717,298,"2094",152,108,44
"493",493,576,247,1442,848,"2095",2377,1208,1169
"494",494,404,155,904,568,"2096",4286,1344,2942
"495",495,623,290,1600,934,"2097",3118,836,2282
"496",496,408,127,739,549,"2098",2027,334,1693
"497",497,1266,1262,3413,2567,"2099",2126,773,1353
"498",498,608,262,1474,889,"2100",1671,251,1420
"499",499,1477,936,3417,2473,"2101",1669,639,1030
"500",500,726,622,1865,1379,"2102",2808,844,1964
"501",501,1686,919,3874,2662,"2103",395,2,393
"502",502,201,49,575,257,"2104",350,33,317
"503",503,926,360,2231,1321,"2105",852,33,819
"504",504,1285,468,3216,1797,"2106",977,192,785
"505",505,173,118,510,298,"2107",4286,1215,3071
"506",506,615,393,1631,1028,"2108",1251,642,609
"507",507,68,60,145,130,"2109",0,0,0
"508",508,908,777,2463,1729,"2110",1652,434,1218
"509",509,1060,452,2580,1551,"2111",1956,367,1589
"510",510,1081,566,2621,1695,"2112",1997,598,1399
"511",511,574,298,1526,892,"2113",170,24,146
"512",512,605,492,1618,1128,"2114",3959,681,3278
"513",513,543,269,1355,835,"2115",7469,2534,4935
"514",514,21,33,72,55,"2116",0,0,0
"515",515,1074,786,2651,1882,"2117",1080,59,1021
"516",516,105,32,329,144,"2118",76,1,75
"517",517,132,38,283,172,"2119",478,142,336
"518",518,235,73,610,315,"2120",2745,862,1883
"519",519,222,95,610,324,"2121",710,152,558
"520",520,1460,894,3522,2410,"2122",3202,777,2425
"521",521,458,444,1178,927,"2123",2420,811,1609
"522",522,1,0,1,1,"2124",685,243,442
"523",523,463,321,1043,802,"2125",3329,1053,2276
"524",524,442,215,1266,676,"2126",2463,535,1928
"525",525,757,461,1799,1253,"2127",2995,960,2035
"526",526,39,15,108,54,"2128",3715,181,3534
"527",527,895,425,2438,1350,"2129",0,0,0
"528",528,1836,1518,4342,3427,"2130",2432,714,1718
"529",529,0,0,0,0,"2131",785,303,482
"530",530,289,70,670,368,"2132",0,0,0
"531",531,13,1,31,15,"2133",389,139,250
"532",532,142,38,319,180,"2134",3246,653,2593
"533",533,951,717,2132,1700,"2135",1214,265,949
"534",534,208,111,545,324,"2136",4486,1565,2921
"535",535,687,267,1803,980,"2137",1600,465,1135
"536",536,760,682,2034,1470,"2138",1706,436,1270
"537",537,296,177,620,482,"2139",2072,663,1409
"538",538,1237,994,2974,2275,"2140",2526,465,2061
"539",539,600,339,1607,953,"2141",1500,405,1095
"540",540,1068,738,2693,1845,"2142",1218,258,960
"541",541,906,312,2587,1242,"2143",2923,847,2076
"542",542,0,0,0,0,"2144",2352,690,1662
"543",543,968,558,2117,1545,"2145",389,115,274
"544",544,183,94,457,285,"2146",177,25,152
"545",545,0,0,3,0,"2147",923,244,679
"546",546,157,105,353,266,"2148",6627,1932,4695
"547",547,529,238,1675,796,"2149",4643,1151,3492
"548",548,314,141,781,473,"2150",17,2,15
"549",549,1713,1309,4255,3087,"2151",204,22,182
"550",550,506,281,1225,806,"2152",924,174,750
"551",551,396,248,1102,658,"2153",664,178,486
"552",552,769,608,1954,1414,"2154",4838,1570,3268
"553",553,765,318,1886,1104,"2155",0,0,0
"554",554,618,403,1437,1046,"2156",2551,826,1725
"555",555,259,110,733,377,"2157",0,0,0
"556",556,813,582,2272,1421,"2158",0,0,0
"557",557,873,437,1915,1348,"2159",232,62,170
"558",558,163,109,355,276,"2160",310,100,210
"559",559,40,14,98,56,"3001",4943,2335,2608
"560",560,243,159,702,410,"3002",2611,905,1706
"561",561,1619,655,4028,2341,"3003",102,49,53
"562",562,902,388,2405,1321,"3004",0,0,0
"563",563,7,1,9,8,"3005",3153,1803,1350
"564",564,11,6,61,17,"3006",1086,534,552
"565",565,234,77,687,323,"3007",3736,1455,2281
"566",566,135,71,425,211,"3008",80,40,40
"567",567,1640,1148,4034,2862,"3009",18,9,9
"568",568,1,0,1,1,"3010",1414,380,1034
"569",569,611,245,1427,870,"3011",1010,541,469
"570",570,0,0,0,0,"3012",1220,714,506
"571",571,0,0,0,0,"3013",2322,913,1409
"572",572,83,66,215,158,"3014",645,265,380
"573",573,3,1,5,4,"3015",1211,458,753
"574",574,86,77,216,163,"3016",195,107,88
"575",575,345,151,785,513,"3017",2450,1817,633
"576",576,1050,701,2554,1804,"3018",1690,1235,455
"577",577,953,537,2309,1529,"3019",1213,440,773
"578",578,1241,904,2919,2180,"3020",2725,2052,673
"579",579,763,521,1722,1307,"3021",2140,1818,322
"580",580,20,10,68,30,"3022",1593,1131,462
"581",581,733,396,1715,1159,"3023",2951,1045,1906
"582",582,664,438,1558,1118,"3024",0,0,0
"583",583,1567,1102,3780,2726,"3025",1653,1221,432
"584",584,672,419,1651,1116,"3026",1389,1079,310
"585",585,175,88,414,273,"3027",1708,1006,702
"586",586,617,341,1581,982,"3028",2460,968,1492
"587",587,1067,757,2565,1868,"3029",1324,538,786
"588",588,790,361,1955,1183,"3030",2202,1477,725
"589",589,548,419,1358,991,"3031",28,8,20
"590",590,0,0,1,0,"3032",2999,1001,1998
"591",591,592,160,1091,774,"3033",2653,1558,1095
"592",592,59,52,156,114,"3034",2478,2027,451
"593",593,1316,729,3104,2091,"3035",977,426,551
"594",594,26,15,62,42,"3036",5726,1819,3907
"595",595,272,225,641,508,"3037",2946,1199,1747
"596",596,61,51,148,116,"3038",1245,509,736
"597",597,52,43,125,98,"3039",4916,2498,2418
"598",598,105,86,248,195,"3040",2222,1085,1137
"599",599,27,22,64,50,"3041",506,279,227
"600",600,26,22,63,50,"3042",2590,1258,1332
"601",601,7,6,19,14,"3043",3055,1857,1198
"602",602,47,40,113,89,"3044",1794,944,850
"603",603,68,58,163,129,"3045",1573,1027,546
"604",604,174,146,413,327,"3046",1365,886,479
"605",605,1304,1337,3760,2680,"3047",1648,1227,421
"606",606,823,1069,2391,1929,"3048",1780,1193,587
"607",607,553,574,1526,1153,"3049",2120,1469,651
"608",608,0,0,0,0,"3050",1502,803,699
"609",609,905,1568,3080,2510,"3051",360,277,83
"610",610,422,433,1098,883,"3052",5655,2426,3229
"611",611,1225,1113,3304,2391,"3053",2626,1706,920
"612",612,35,46,100,81,"3054",1826,592,1234
"613",613,0,11,15,12,"3055",3454,2307,1147
"614",614,294,124,702,424,"3056",2915,862,2053
"615",615,428,379,975,819,"3057",733,364,369
"616",616,376,625,1224,1025,"3058",5554,1913,3641
"617",617,805,554,1908,1394,"3059",2760,1216,1544
"618",618,198,185,568,394,"3060",2124,993,1131
"619",619,677,508,1765,1210,"3061",2848,952,1896
"620",620,0,0,0,0,"3062",67,20,47
"621",621,688,1401,2601,2138,"3063",2131,975,1156
"622",622,770,726,1830,1522,"3064",444,229,215
"623",623,0,0,0,0,"3065",132,32,100
"624",624,1209,851,2639,2119,"3066",2064,955,1109
"625",625,673,1320,2363,2049,"3067",1453,800,653
"626",626,717,603,1631,1346,"3068",4610,1061,3549
"627",627,20,36,68,57,"3069",3623,1764,1859
"628",628,0,0,0,0,"3070",2527,1391,1136
"629",629,702,674,1760,1404,"3071",3357,1216,2141
"630",630,616,621,1492,1266,"3072",4637,2190,2447
"631",631,590,596,1530,1221,"3073",1727,803,924
"632",632,754,730,2170,1508,"3074",2602,1543,1059
"633",633,549,388,1286,966,"3075",2804,1903,901
"634",634,852,953,2235,1845,"3076",1226,889,337
"635",635,12,6,25,18,"3077",2392,1451,941
"636",636,10,9,24,19,"3078",3183,1720,1463
"637",637,662,1011,2209,1694,"3079",3609,1961,1648
"638",638,563,1556,2628,2152,"3080",1347,687,660
"639",639,350,272,856,633,"3081",2787,1395,1392
"640",640,1871,1011,4419,2953,"3082",2939,1309,1630
"641",641,34,34,94,69,"3083",2071,1091,980
"642",642,487,423,1256,932,"3084",4087,1874,2213
"643",643,1267,1964,4455,3293,"3085",1518,822,696
"644",644,850,759,2170,1639,"3086A",1790,1041,749
"645",645,219,222,547,448,"3086B",0,0,0
"646",646,851,997,2444,1890,"3087",1936,965,971
"647",647,829,1498,2968,2377,"3088",4575,2267,2308
"648",648,594,530,1565,1144,"3089",4630,2849,1781
"649",649,543,705,1607,1277,"3090",3814,1843,1971
"650",650,670,521,1528,1215,"3091",801,605,196
"651",651,802,670,1811,1506,"3092",2557,1906,651
"652",652,742,517,1663,1298,"3093",4963,2635,2328
"653",653,835,917,2183,1786,"3094",5884,2762,3122
"654",654,450,432,1196,906,"3095",4747,1591,3156
"655",655,113,190,372,309,"3096",3288,1843,1445
"656",656,536,576,1554,1129,"3097",11,10,1
"657",657,772,689,2034,1493,"3098",1333,685,648
"658",658,69,17,154,88,"3099",3709,1425,2284
"659",659,825,1786,3289,2661,"3100",3944,1628,2316
"660",660,900,499,2368,1431,"3101",2880,1340,1540
"661",661,222,215,602,446,"3102",3503,2022,1481
"662",662,1553,871,3767,2498,"3103",1013,265,748
"663",663,685,742,2119,1455,"3104",2819,1642,1177
"664",664,809,621,2003,1462,"3105",3984,1689,2295
"665",665,767,566,2122,1369,"3106A",1695,1015,680
"666",666,13,9,43,22,"3106B",0,0,0
"667",667,808,654,1956,1486,"3107",2211,821,1390
"668",668,193,150,424,347,"3108",1506,916,590
"669",669,1208,1285,3454,2527,"3109",4335,1191,3144
"670",670,788,653,1945,1466,"3110",3296,1396,1900
"671",671,652,577,1546,1260,"3111",0,0,0
"672",672,1144,525,2929,1724,"3112",2306,747,1559
"673",673,1382,1120,3256,2552,"3113",1860,666,1194
"674",674,1019,935,2502,1994,"3114",2182,1511,671
"675",675,1097,694,2676,1828,"3115",1761,1075,686
"676",676,1458,1794,4405,3318,"3116",1691,573,1118
"677",677,716,510,1646,1264,"3117",3188,1906,1282
"678",678,1010,1027,2599,2087,"3118",1304,602,702
"679",679,1042,1510,3104,2604,"3119",5400,2360,3040
"680",680,479,640,1378,1142,"3120",3906,1810,2096
"681",681,1032,953,2472,2029,"3121",5547,2550,2997
"682",682,1142,1093,2960,2287,"3122",2815,1501,1314
"683",683,1265,1209,3286,2519,"3123",1249,486,763
"684",684,437,455,1189,913,"3124",5282,2355,2927
"685",685,900,788,2332,1726,"3125A",4006,1821,2185
"686",686,931,852,2560,1835,"3125B",16,6,10
"687",687,555,623,1704,1210,"3126",2035,1021,1014
"688",688,1247,1216,3487,2518,"3127",4854,1576,3278
"689",689,494,449,1291,974,"3128",68,48,20
"690",690,701,723,1818,1465,"3129",3539,1231,2308
"691",691,528,668,1748,1214,"3130",1686,1120,566
"692",692,1345,1480,3805,2889,"3131",6,3,3
"693",693,1046,1862,3605,2960,"3132",2834,871,1963
"694",694,1130,1222,3316,2428,"3133",0,0,0
"695",695,227,463,864,710,"3134",3462,1091,2371
"696",696,760,1360,2575,2169,"3135",1211,540,671
"697",697,986,1166,2811,2191,"3136",545,241,304
"698",698,1371,1698,4065,3110,"3137",5786,2436,3350
"699",699,1240,633,3280,1912,"3138",71,36,35
"700",700,1109,1449,3232,2612,"3139",1995,697,1298
"701",701,1,10,13,11,"3140",487,105,382
"702",702,491,496,1283,1008,"3141",2363,656,1707
"703",703,1410,1303,3533,2751,"3142",1080,372,708
"704",704,1307,1120,3456,2490,"3143",1646,628,1018
"705",705,1075,1038,2730,2158,"3144",447,208,239
"706",706,1163,1233,3169,2449,"3145",4052,1921,2131
"707",707,320,218,813,547,"3146",4643,1701,2942
"708",708,968,1083,2733,2100,"3147",2856,1111,1745
"709",709,1227,1184,3521,2469,"3148",1361,687,674
"710",710,491,833,1681,1346,"3149",4491,1082,3409
"711",711,300,536,1027,845,"3150",35,4,31
"712",712,546,686,1552,1252,"3151",3369,1625,1744
"713",713,1207,877,3382,2135,"3152",3836,1095,2741
"714",714,1154,1093,3133,2290,"3153",1642,829,813
"715",715,0,0,0,0,"3154",1689,1109,580
"716",716,712,353,1695,1099,"3155",3093,1555,1538
"717",717,475,222,1201,723,"3156",0,0,0
"718",718,710,1165,2350,1905,"3157",2697,1611,1086
"719",719,723,761,1798,1516,"3158",101,30,71
"720",720,633,738,1889,1400,"3159",3963,1189,2774
"721",721,1136,1273,3112,2458,"3160",1751,872,879
"722",722,410,343,1059,769,"3161",4480,1438,3042
"723",723,1013,744,2575,1809,"3162",1262,450,812
"724",724,1291,1221,3479,2574,"3163",2748,1477,1271
"725",725,1124,1161,3186,2322,"3164",2054,1209,845
"726",726,890,872,2420,1788,"3165",4152,2049,2103
"727",727,212,329,827,552,"3166",722,246,476
"728",728,1548,1754,4308,3364,"3167",50,16,34
"729",729,1344,1554,3806,2955,"3168",603,222,381
"730",730,704,844,1883,1577,"3169",189,96,93
"731",731,661,782,1878,1466,"3170",1,0,1
"732",732,15,25,55,41,"3171",0,0,0
"733",733,1448,929,3357,2438,"3172",737,216,521
"734",734,644,825,1858,1518,"3173",3855,1588,2267
"735",735,0,2,3,2,"3174",4270,2393,1877
"736",736,590,312,1636,916,"3175",723,295,428
"737",737,0,0,0,0,"3176",48,19,29
"738",738,1213,509,3056,1768,"3177",0,0,0
"739",739,432,239,994,688,"3178",1,0,1
"740",740,571,418,1444,1016,"3179",0,0,0
"741",741,1104,1275,3280,2434,"3180",1290,642,648
"742",742,13,31,65,47,"3181",2575,1321,1254
"743",743,466,483,1323,965,"3182",796,374,422
"744",744,28,30,84,60,"3183",44,15,29
"745",745,44,45,123,91,"3184",478,163,315
"746",746,14,4,30,18,"3185",305,107,198
"747",747,3,0,4,3,"3186",0,0,0
"748",748,215,130,557,353,"3187",0,0,0
"749",749,640,500,1567,1154,"3188",0,0,0
"750",750,224,168,443,401,"3189",1116,451,665
"751",751,1397,1361,3629,2822,"3190",641,203,438
"752",752,1597,880,3577,2533,"3191",237,111,126
"753",753,48,16,95,65,"3192",0,0,0
"754",754,460,589,1341,1063,"3193",176,108,68
"755",755,920,250,3393,1209,"3194",4727,2693,2034
"756",756,15,15,38,30,"3195",2621,773,1848
"757",757,1081,1323,3073,2452,"3196",15,7,8
"758",758,278,343,763,628,"3197",0,0,0
"759",759,589,575,1556,1183,"3198",788,278,510
"760",760,600,723,1726,1351,"3199A",3883,1772,2111
"761",761,1019,1206,3004,2266,"3199B",0,0,0
"762",762,7,7,15,14,"3200",0,0,0
"763",763,1054,1038,2722,2134,"3201",4426,2319,2107
"764",764,29,31,70,60,"3202",1247,578,669
"765",765,929,564,2614,1523,"3203",491,239,252
"766",766,577,680,1666,1282,"3204",4,4,0
"767",767,1096,671,2884,1813,"3205",0,0,0
"768",768,1131,839,2702,2005,"3206A",249,82,167
"769",769,928,1063,2673,2036,"3206B",0,0,0
"770",770,610,965,2071,1597,"3206C",0,0,0
"771",771,1413,1517,3835,3005,"3207",411,118,293
"772",772,221,165,537,397,"3208",116,74,42
"773",773,1,1,12,2,"3209",743,388,355
"774",774,251,216,583,472,"3210",4217,1816,2401
"775",775,39,68,143,109,"4001",4485,2188,2297
"776",776,0,0,0,0,"4002",1446,103,1343
"777",777,0,0,0,0,"4003",2216,183,2033
"778",778,265,131,604,405,"4004",1666,464,1202
"779",779,1424,1428,3768,2900,"4005",2157,333,1824
"780",780,1483,1959,4230,3502,"4006",738,248,490
"781",781,247,218,628,470,"4007A",5904,3005,2899
"782",782,20,19,42,39,"4007B",0,0,0
"783",783,0,0,0,0,"4007C",0,0,0
"784",784,0,0,0,0,"4007D",0,0,0
"785",785,0,0,0,0,"4007E",0,0,0
"786",786,490,371,1165,879,"4008",1170,528,642
"787",787,853,1004,2405,1895,"4009",1644,118,1526
"788",788,339,277,785,624,"4010",2518,135,2383
"789",789,1,11,17,12,"4011",2334,168,2166
"790",790,71,79,265,155,"4012",1186,47,1139
"791",791,126,89,281,221,"4013",1253,123,1130
"792",792,0,0,0,0,"4014",663,58,605
"793",793,0,0,0,0,"4015",2450,479,1971
"794",794,0,0,0,0,"4016",3209,325,2884
"795",795,495,370,1108,879,"4017",2810,939,1871
"796",796,184,100,449,292,"4018",1082,605,477
"797",797,85,83,225,168,"4019",4687,723,3964
"798",798,0,0,0,0,"4020",2596,615,1981
"799",799,76,79,211,157,"4021",1545,384,1161
"800",800,1299,1997,4259,3379,"4022",366,76,290
"801",801,925,325,2378,1283,"4023",3074,630,2444
"802",802,2,10,18,12,"4024",3888,771,3117
"803",803,0,0,0,0,"4025",1909,319,1590
"804",804,310,269,758,591,"4026",5124,591,4533
"805",805,1143,1440,3580,2627,"4027",2059,327,1732
"806",806,0,0,0,0,"4028",2926,412,2514
"807",807,1339,2064,4403,3466,"4029",3219,248,2971
"808",808,430,441,1168,890,"4030",677,21,656
"809",809,152,229,490,387,"4031",2576,212,2364
"810",810,0,0,0,0,"4032",2368,314,2054
"811",811,0,0,1,0,"4033",4872,829,4043
"812",812,1123,463,2435,1625,"4034",2292,394,1898
"813",813,364,113,1078,490,"4035",26,15,11
"814",814,572,113,1497,704,"4036",3427,424,3003
"815",815,303,97,692,407,"4037",2613,128,2485
"816",816,823,192,1860,1048,"4038",3393,1892,1501
"817",817,327,90,708,425,"4039",1790,71,1719
"818",818,441,377,1987,858,"4040",1727,159,1568
"819",819,261,167,659,439,"4041",2625,213,2412
"820",820,374,93,1102,474,"4042",409,88,321
"821",821,897,163,2273,1080,"4043",3598,1018,2580
"822",822,476,70,1184,556,"4044",2207,637,1570
"823",823,342,85,976,433,"4045",3332,979,2353
"824",824,390,144,1007,548,"4046",3346,1752,1594
"825",825,194,47,489,250,"4047",4115,919,3196
"826",826,796,217,1845,1045,"4048",2681,247,2434
"827",827,1028,331,2402,1392,"4049",3875,773,3102
"828",828,1085,266,2378,1405,"4050",1969,957,1012
"829",829,643,171,1056,827,"4051",1875,1037,838
"830",830,1010,449,2903,1492,"4052",2886,1224,1662
"831",831,495,306,1421,814,"4053",2976,949,2027
"832",832,415,270,1178,694,"4054",4268,1486,2782
"833",833,55,49,272,104,"4055",1878,913,965
"834",834,942,569,2400,1535,"4056",4368,1776,2592
"835",835,1093,552,2861,1682,"4057",1613,996,617
"836",836,482,234,1309,730,"4058",2534,1227,1307
"837",837,1357,548,3651,1949,"4059",2781,1120,1661
"838",838,702,290,1627,1011,"4060",2634,742,1892
"839",839,1126,357,2390,1517,"4061",4027,758,3269
"840",840,980,222,2534,1233,"4062",987,167,820
"841",841,160,18,426,182,"4063",1617,271,1346
"842",842,698,276,1966,999,"4064",2938,935,2003
"843",843,679,357,1770,1056,"4065",6267,933,5334
"844",844,1343,646,3410,2030,"4066",4322,991,3331
"845",845,665,333,1787,1018,"4067",2845,842,2003
"846",846,13,10,32,25,"4068",957,217,740
"847",847,1279,277,2694,1596,"4069",991,514,477
"848",848,734,120,1914,874,"4070",3877,604,3273
"849",849,1284,697,2760,2027,"4071",1552,1153,399
"850",850,590,68,1413,673,"4072",3413,1944,1469
"851",851,552,117,1255,680,"4073",2288,794,1494
"852",852,964,144,2108,1136,"4074",3024,966,2058
"853",853,97,58,210,161,"4075",791,90,701
"854",854,1217,716,3125,1976,"4076",5474,961,4513
"855",855,538,298,1454,850,"4077",5803,1030,4773
"856",856,936,584,2549,1561,"4078",1633,1044,589
"857",857,985,847,2669,1883,"4079",2103,962,1141
"858",858,998,548,2948,1586,"4080",3303,713,2590
"859",859,765,241,1993,1029,"4081",828,455,373
"860",860,952,476,2649,1467,"4082",2908,260,2648
"861",861,536,627,1688,1193,"4083",890,287,603
"862",862,659,741,1834,1427,"4084",1040,158,882
"863",863,805,709,2273,1546,"4085",68,42,26
"864",864,852,574,2269,1456,"4086",775,313,462
"865",865,1434,1179,3922,2681,"4087",2350,750,1600
"866",866,505,564,1618,1110,"4088",4980,1180,3800
"867",867,1037,1065,3435,2158,"4089",4150,1501,2649
"868",868,530,799,1714,1351,"4090",3066,1154,1912
"869",869,492,788,2061,1305,"4091",1337,559,778
"870",870,799,685,2400,1522,"4092",2086,970,1116
"871",871,715,494,2167,1238,"4093",3420,1223,2197
"872",872,931,400,2747,1372,"4094",2227,1035,1192
"873",873,310,146,738,460,"4095",2030,768,1262
"874",874,314,208,1136,535,"4096",4482,1263,3219
"875",875,807,663,2425,1505,"4097",3068,1215,1853
"876",876,743,297,2023,1060,"4098",2181,796,1385
"877",877,1414,701,3461,2159,"4099",1851,499,1352
"878",878,583,441,2026,1055,"4100",1007,330,677
"879",879,310,163,673,480,"4101",1535,564,971
"880",880,293,471,968,774,"4102",1754,373,1381
"881",881,1492,601,3216,2130,"4103",10,4,6
"882",882,202,973,1530,1195,"4104",2740,955,1785
"883",883,637,1558,3044,2227,"4105",2158,948,1210
"884",884,538,549,1780,1104,"4106",1038,133,905
"885",885,581,717,2307,1331,"4107",1212,476,736
"886",886,301,80,683,388,"4108",5091,1822,3269
"887",887,1310,710,3676,2069,"4109",1739,412,1327
"888",888,1331,812,3486,2185,"4110",1588,652,936
"889",889,232,741,1389,990,"4111",682,62,620
"890",890,496,585,1703,1099,"4112",850,636,214
"891",891,871,475,2412,1371,"4113",1476,177,1299
"892",892,183,205,852,407,"4114",153,24,129
"893",893,766,183,2088,977,"4115",219,106,113
"894",894,327,221,871,575,"4116",56,25,31
"895",895,274,99,665,386,"4117",554,287,267
"896",896,5,35,59,41,"4118",90,47,43
"897",897,118,207,546,330,"4119",826,392,434
"898",898,1158,605,2227,1789,"4120",525,158,367
"899",899,1668,777,4054,2499,"4121",362,178,184
"900",900,1250,938,3363,2239,"4122",92,48,44
"901",901,741,633,2342,1412,"4123",165,31,134
"902",902,444,233,1062,692,"4124",4056,564,3492
"903",903,568,571,1729,1161,"4125",208,51,157
"904",904,991,790,2784,1825,"4126",2311,1058,1253
"905",905,671,575,1921,1277,"4127",141,27,114
"906",906,636,508,1758,1172,"4128",194,77,117
"907",907,950,571,2823,1561,"4129",174,66,108
"908",908,762,689,2255,1480,"4130",998,360,638
"909",909,564,505,1732,1100,"4131",638,157,481
"910",910,474,281,1343,781,"4132",2614,716,1898
"911",911,393,293,962,699,"4133",60,30,30
"912",912,295,435,1160,747,"4134",16,6,10
"913",913,311,162,1021,484,"4135",0,0,0
"914",914,0,0,0,0,"4136",1408,524,884
"915",915,748,638,2184,1410,"4137",158,116,42
"916",916,376,466,1198,864,"4138",0,0,0
"917",917,180,75,617,260,"4139",16,4,12
"918",918,485,424,1218,932,"4140",0,0,0
"919",919,1305,949,3781,2309,"4141",688,41,647
"920",920,556,334,1386,916,"4142",1215,172,1043
"921",921,614,183,1236,824,"4143",6264,1228,5036
"922",922,172,22,464,203,"4144",600,356,244
"923",923,296,320,771,624,"4145",24,11,13
"924",924,411,96,959,513,"4146",62,19,43
"925",925,31,16,84,47,"4147",398,211,187
"926",926,71,81,206,153,"4148",210,62,148
"927",927,19,16,41,35,"4149",829,200,629
"928",928,219,173,538,396,"4150",2316,544,1772
"929",929,15,40,80,57,"4151",639,454,185
"930",930,326,98,666,434,"4152",2748,802,1946
"931",931,74,36,239,115,"4153",246,90,156
"932",932,57,84,213,141,"4154",915,225,690
"933",933,40,14,73,55,"4155",2909,843,2066
"934",934,70,23,149,94,"4156",1510,309,1201
"935",935,835,296,2367,1156,"4157",2052,483,1569
"936",936,23,14,105,41,"4158",874,375,499
"937",937,589,655,1812,1262,"4159",54,18,36
"938",938,19,13,83,32,"4160",2914,442,2472
"939",939,81,39,153,122,"4161",1191,173,1018
"940",940,20,63,132,84,"4162",3154,1057,2097
"941",941,305,249,850,572,"4163",2331,583,1748
"942",942,166,76,410,246,"4164",2657,1365,1292
"943",943,1077,569,2524,1689,"4165",147,87,60
"944",944,3,15,33,18,"4166",514,91,423
"945",945,3,1,6,4,"4167",138,44,94
"946",946,0,0,0,0,"4168",2919,653,2266
"947",947,349,381,988,748,"4169",410,240,170
"948",948,14,75,124,90,"4170",652,192,460
"949",949,0,0,0,0,"4171",1332,608,724
"950",950,0,0,1,1,"4172",1939,723,1216
"951",951,0,0,0,0,"4173",2387,992,1395
"952",952,118,37,467,160,"4174",1906,494,1412
"953",953,296,58,828,364,"4175",0,0,0
"954",954,1102,434,2549,1585,"4176",1167,655,512
"955",955,155,237,540,404,"4177",37,0,37
"956",956,3,2,9,5,"4178",7,0,7
"957",957,11,7,44,19,"4179",3252,1415,1837
"958",958,124,93,319,221,"4180",4,0,4
"959",959,50,49,156,99,"4181",18,0,18
"960",960,169,102,564,279,"4182",0,0,0
"961",961,815,377,1875,1219,"4183",71,35,36
"962",962,99,339,610,447,"4184",26,0,26
"963",963,789,476,2190,1298,"4185",3,0,3
"964",964,58,53,161,112,"4186",108,69,39
"965",965,262,196,761,465,"4187",0,0,0
"966",966,1243,366,2425,1646,"4188",0,0,0
"967",967,496,210,1173,725,"4189",1205,267,938
"968",968,850,192,1792,1064,"4190",15,5,10
"969",969,199,116,564,324,"4191",13,0,13
"970",970,4,9,25,13,"4192",1,1,0
"971",971,860,375,2095,1254,"4193",155,29,126
"972",972,360,65,757,433,"4194",1597,521,1076
"973",973,877,708,2558,1623,"4195",7,4,3
"974",974,929,456,2254,1419,"4196",0,0,0
"975",975,694,901,2472,1644,"4197",29,7,22
"976",976,23,47,139,73,"4198",2121,485,1636
"977",977,159,69,365,232,"4199",2120,601,1519
"978",978,6,11,57,17,"4200",3586,451,3135
"979",979,980,452,2562,1465,"4201",67,55,12
"980",980,111,140,359,256,"4202",5,3,2
"981",981,140,105,453,247,"4203",347,164,183
"982",982,466,456,1257,949,"4204",28,0,28
"983",983,509,413,1487,940,"4205",172,50,122
"984",984,580,514,1727,1121,"4206",757,225,532
"985",985,530,346,1508,901,"4207",0,0,0
"986",986,0,0,0,0,"4208",4,3,1
"987",987,347,371,989,732,"4209",46,20,26
"988",988,25,2,45,28,"4210",23,8,15
"989",989,2,0,3,2,"4211",40,19,21
"990",990,1066,927,2921,2053,"4212",7,1,6
"991",991,0,3,4,3,"4213",4,3,1
"992",992,0,1,3,1,"0102",2332,1761,571
"993",993,0,0,0,0,"0201",2330,1929,401
"994",994,53,13,84,67,"0302",1262,999,263
"995",995,10,1,28,11,"0303",602,503,99
"996",996,0,1,1,1,"0304",324,265,59
"997",997,62,13,93,79,"0401",2571,2004,567
"998",998,0,0,0,0,"0004A",92,81,11
"999",999,0,0,0,0,"0004B",50,43,7
"1000",1000,395,189,998,592,"001A",65,61,4
"1001",1001,0,1,6,2,"001B",51,51,0
"1002",1002,1,0,3,1,"002AA",59,46,13
"1003",1003,0,0,0,0,"002AB",15,11,4
"1004",1004,26,13,85,39,"002B",54,50,4
"1005",1005,238,214,1007,470,"003A",42,38,4
"1006",1006,0,0,0,0,"003B",43,33,10
"1007",1007,0,0,0,0,"0001",693,601,92
"1008",1008,2,1,4,3,"0002",1332,865,467
"1009",1009,729,269,1801,1016,"0003",1266,925,341
"1010",1010,520,307,1436,856,"0004",598,464,134
"1011",1011,1318,657,2812,2021,"0005",1956,1758,198
"1012",1012,3,10,22,13,"0006",1474,1301,173
"1013",1013,0,0,0,0,"0007",683,595,88
"1014",1014,215,43,365,263,"0008A",2723,2078,645
"1015",1015,3,1,7,4,"0008B",9,0,9
"1016",1016,45,40,143,85,"0009",1210,824,386
"1017",1017,189,148,578,353,"0010",1658,1241,417
"1018",1018,0,0,0,0,"0011",854,740,114
"1019",1019,0,0,0,0,"0007",4552,2819,1733
"1020",1020,11,35,65,46,"0009",3727,2111,1616
"1021",1021,8,3,18,12,"0010",1911,1528,383
"1022",1022,18,2,36,21,"0011",2712,2272,440
"1023",1023,0,0,0,0,"0012",2349,2048,301
"1024",1024,17,10,28,27,"0013",182,149,33
"1025",1025,615,459,1635,1099,"0014",3786,2531,1255
"1026",1026,60,54,205,115,"0015",625,547,78
"1027",1027,265,192,809,473,"0016",1507,1351,156
"1028",1028,55,23,119,79,"0017",1841,1582,259
"1029",1029,66,23,152,91,"0018",5440,2717,2723
"1030",1030,0,0,0,0,"0019",832,723,109
"1031",1031,2,0,6,3,"001A",2172,306,1866
"1032",1032,0,0,0,0,"001B",1609,467,1142
"1033",1033,136,73,288,213,"0020",669,366,303
"1034",1034,9,7,33,17,"0021",330,249,81
"1035",1035,0,0,0,0,"0022",340,261,79
"1036",1036,205,253,655,474,"0024",569,512,57
"1037",1037,53,68,174,125,"0025",1412,1094,318
"1038",1038,0,0,0,0,"0027",841,775,66
"1039",1039,294,124,642,428,"0028",731,654,77
"1040",1040,919,369,2489,1307,"0029",452,392,60
"1041",1041,911,359,2108,1308,"002A",1401,349,1052
"1042",1042,434,1316,2233,1785,"002B",667,212,455
"1043",1043,478,1366,2322,1871,"002C",1813,314,1499
"1044",1044,343,811,1485,1168,"002D",120,54,66
"1045",1045,172,553,903,735,"0030",1843,1336,507
"1046",1046,484,1397,2386,1918,"003A",1767,1148,619
"1047",1047,2,79,106,81,"003B",2738,1090,1648
"1048",1048,2,57,67,61,"004A",1511,599,912
"1049",1049,2,44,61,46,"004B",2233,1394,839
"1050",1050,4,62,85,67,"004C",869,276,593
"1051",1051,1,41,45,42,"004D",100,44,56
"1052",1052,3,65,87,68,"004E",0,0,0
"1053",1053,2,49,48,52,"005A",308,173,135
"1054",1054,62,489,729,558,"005B",6,1,5
"1055",1055,108,503,1004,622,"005C",4990,3730,1260
"1056",1056,127,725,1193,870,"006A",2641,1989,652
"1057",1057,45,309,487,357,"006B",2119,1620,499
"1058",1058,243,980,1665,1239,"008A",955,369,586
"1059",1059,168,774,1281,954,"008B",3989,2901,1088
"1060",1060,78,449,679,537,"008C",2878,1930,948
"1061",1061,322,1319,2297,1674,"0001",5806,2641,3165
"1062",1062,107,533,949,651,"0002",4663,3024,1639
"1063",1063,203,846,1562,1069,"0003",6096,3851,2245
"1064",1064,98,542,876,657,"0004",4708,2718,1990
"1065",1065,902,1637,4071,2589,"0005",2713,1517,1196
"1066",1066,635,1239,3167,1912,"0006",1738,1239,499
"1067",1067,266,1139,1947,1423,"0007",3898,873,3025
"1068",1068,83,562,913,651,"0008",1658,1202,456
"1069",1069,228,1598,2532,1851,"0009",5351,2043,3308
"1070",1070,5,6,32,11,"0010",1142,753,389
"1071",1071,138,368,839,511,"0011",4946,2000,2946
"1072",1072,45,354,569,406,"0012",4289,1941,2348
"1073",1073,83,862,1443,955,"0013",4704,2190,2514
"1074",1074,160,1072,1913,1245,"0014",5784,3936,1848
"1075",1075,281,1356,2458,1662,"0015",3271,2325,946
"1076",1076,38,591,858,631,"0016",7209,4093,3116
"1077",1077,482,76,1390,575,"0017",3873,1117,2756
"1078",1078,452,204,1388,663,"0018",4844,2857,1987
"1079",1079,75,137,350,215,"0019",3508,1060,2448
"1080",1080,38,134,271,176,"0020",1955,1262,693
"1081",1081,22,140,220,163,"0021",9516,2596,6920
"1082",1082,42,379,600,424,"0022",4018,2951,1067
"1083",1083,151,711,1324,872,"0023",5731,3253,2478
"1084",1084,18,478,724,501,"0024",6255,3374,2881
"1085",1085,34,542,819,578,"0025",2768,1442,1326
"1086",1086,30,232,384,263,"0026",5498,1805,3693
"1087",1087,501,146,1289,656,"0027",2284,1376,908
"1088",1088,156,68,523,231,"0028",4349,1955,2394
"1089",1089,528,76,1517,614,"0029",3973,1080,2893
"1090",1090,14,12,94,28,"0030",3766,2326,1440
"1091",1091,387,1296,2753,1713,"0031",1524,993,531
"1092",1092,326,534,1534,875,"0032",3191,2243,948
"1093",1093,345,330,1682,692,"0033",2308,1586,722
"1094",1094,312,227,1122,549,"0034",6387,3273,3114
"1095",1095,301,486,1270,800,"0035",1949,1375,574
"1096",1096,299,310,1127,618,"0036",2622,889,1733
"1097",1097,11,21,46,32,"0037",4046,2018,2028
"1098",1098,55,87,293,146,"0038",813,669,144
"1099",1099,1,0,2,1,"0039",6554,3440,3114
"1100",1100,775,2502,4947,3322,"0040",6066,3422,2644
"1101",1101,469,1116,2421,1612,"0041",2367,864,1503
"1102",1102,408,1225,2333,1667,"0042",863,462,401
"1103",1103,298,191,868,497,"0043",6375,3646,2729
"1104",1104,546,1605,3409,2179,"0044",4881,1744,3137
"1105",1105,161,737,1467,908,"0045",3893,2501,1392
"1106",1106,33,52,184,85,"0046",5718,3186,2532
"1107",1107,179,1151,1874,1345,"0047",3476,1567,1909
"1108",1108,4,25,40,29,"0048",4431,1897,2534
"1109",1109,272,731,1664,1016,"0049",1810,1486,324
"1110",1110,6,51,85,58,"0050",6897,1497,5400
"1111",1111,7,29,54,37,"0051",3556,2401,1155
"1112",1112,73,138,359,213,"0052",3250,1906,1344
"1113",1113,17,90,144,109,"0053",3143,557,2586
"1114",1114,836,1825,4581,2711,"0054",3314,1138,2176
"1115",1115,666,2003,4024,2713,"0055",3893,2131,1762
"1116",1116,729,2206,4538,2978,"0056",5319,3025,2294
"1117",1117,510,1635,3252,2171,"0057",4078,2384,1694
"1118",1118,340,1124,2133,1471,"0058",3753,1267,2486
"1119",1119,143,988,1552,1148,"0059",5367,1497,3870
"1120",1120,672,741,2943,1433,"0060",5412,2305,3107
"1121",1121,107,459,926,572,"0061",1153,743,410
"1122",1122,236,375,895,620,"0062",5454,1874,3580
"1123",1123,98,585,1053,691,"0063",4712,785,3927
"1124",1124,979,1212,3005,2217,"0064",69,25,44
"1125",1125,984,1517,3682,2542,"0066",4864,1088,3776
"1126",1126,1342,1820,4438,3233,"0067",5114,1068,4046
"1127",1127,766,2643,5039,3450,"0068",6964,1530,5434
"1128",1128,201,1554,2424,1783,"0001",2179,1626,553
"1129",1129,334,849,2035,1205,"0002",5665,4169,1496
"1130",1130,782,771,3290,1587,"0003",1363,621,742
"1131",1131,1172,2373,4702,3599,"0004",3073,277,2796
"1132",1132,526,630,2436,1172,"0005",1955,1419,536
"1133",1133,208,850,1576,1070,"0006",1120,859,261
"1134",1134,1260,953,3275,2251,"0007",1888,1532,356
"1135",1135,742,2233,4028,3046,"0008",3144,1619,1525
"1136",1136,800,2084,4683,2947,"0009",2730,1641,1089
"1137",1137,225,648,1346,883,"0010",4572,2859,1713
"1138",1138,261,842,1710,1121,"0011",6070,2826,3244
"1139",1139,1345,1549,4223,2928,"0012",5324,3467,1857
"1140",1140,871,920,2319,1808,"0013",3048,1820,1228
"1141",1141,1296,1815,4313,3167,"0014",6205,840,5365
"1142",1142,1692,1056,3793,2776,"0015",3934,2733,1201
"1143",1143,471,1731,2851,2236,"0016",2331,299,2032
"1144",1144,143,704,1206,856,"0017",5293,2013,3280
"1145",1145,354,1560,2785,1928,"0018",861,126,735
"1146",1146,406,1024,2025,1446,"0019",670,137,533
"1147",1147,950,2908,5903,3912,"0020",11872,6517,5355
"1148",1148,212,991,1653,1218,"0021",5679,3053,2626
"1149",1149,424,754,2090,1189,"0022",812,233,579
"1150",1150,989,1498,3445,2525,"0023",95,63,32
"1151",1151,145,425,839,576,"0024",3017,1818,1199
"1152",1152,665,1454,3494,2161,"0025",1250,104,1146
"1153",1153,541,1155,2394,1723,"0026",4013,2723,1290
"1154",1154,984,652,2226,1663,"0027",3367,2607,760
"1155",1155,158,305,784,471,"0028",368,319,49
"1156",1156,937,2017,4551,3001,"0029",847,577,270
"1157",1157,2010,1249,4492,3310,"0030",3731,945,2786
"1158",1158,693,1724,3475,2466,"0031",7031,4009,3022
"1159",1159,1135,2090,4557,3289,"0032",9,3,6
"1160",1160,788,1201,2997,2024,"0033",3528,1791,1737
"1161",1161,646,1241,3269,1922,"0034",10107,5348,4759
"1162",1162,177,1093,1641,1287,"0035",18295,10471,7824
"1163",1163,1658,641,3168,2329,"0036",5889,3285,2604
"1164",1164,696,1930,3508,2661,"0037",134,103,31
"1165",1165,760,1533,3126,2336,"0038",533,37,496
"1166",1166,1416,500,2547,1936,"0039",5571,3676,1895
"1167",1167,1400,818,3114,2265,"0040",5689,3885,1804
"1168",1168,677,1502,3296,2210,"0041",4556,3674,882
"1169",1169,959,2123,4726,3148,"0042",0,0,0
"1170",1170,187,658,1242,852,"0043",1102,388,714
"1171",1171,1558,913,3214,2499,"0044",125,95,30
"1172",1172,1341,617,2644,1988,"0045",141,93,48
"1173",1173,1815,1681,4867,3556,"0046",627,261,366
"1174",1174,156,542,1031,711,"0047",682,285,397
"1175",1175,1805,1227,4579,3075,"0048",296,189,107
"1176",1176,2231,702,4170,2975,"0049",780,476,304
"1177",1177,6,21,34,27,"0050",11,7,4
"1178",1178,657,1401,2898,2089,"0051",0,0,0
"1179",1179,2064,978,3808,3076,"0052",21,8,13
"1180",1180,1407,540,2843,1970,"0053",296,194,102
"1181",1181,1072,523,2054,1614,"0056",15,15,0
"1182",1182,1126,432,2138,1572,"0057",637,137,500
"1183",1183,1539,765,2963,2335,"0058",1396,960,436
"1184",1184,545,211,1096,762,"0059",33,22,11
"1185",1185,1289,589,2532,1902,"0060",110,85,25
"1186",1186,328,402,1016,741,"0061",41,33,8
"1187",1187,63,201,409,270,"0062",0,0,0
"1188",1188,570,1606,3346,2207,"0063",6219,4641,1578
"1189",1189,235,787,1527,1036,"0064",0,0,0
"1190",1190,760,1828,4398,2639,"0065",255,183,72
"1191",1191,957,726,2489,1707,"0067",491,230,261
"1192",1192,327,1279,2066,1629,"0068",0,0,0
"1193",1193,602,1492,2734,2137,"0069",5917,4090,1827
"1194",1194,248,409,1008,665,"0070",1492,892,600
"1195",1195,750,108,1779,867,"0071",112,85,27
"1196",1196,261,1122,1793,1400,"0072",36,29,7
"1197",1197,133,637,1019,783,"0074",1219,546,673
"1198",1198,222,1206,1763,1438,"0077",946,301,645
"1199",1199,566,490,1767,1102,"0078",293,168,125
"1200",1200,479,549,1537,1059,"0079",103,61,42
"1201",1201,1129,1754,4017,2968,"0080",4130,2899,1231
"1202",1202,1052,831,3148,1948,"0081",81,50,31
"1203",1203,1207,1797,4324,3105,"0082",354,314,40
"1204",1204,689,935,2363,1682,"0083",0,0,0
"1205",1205,1012,455,2842,1501,"0086",4,0,4
"1206",1206,877,1466,3188,2391,"0087",0,0,0
"1207",1207,484,174,1412,671,"0088",0,0,0
"1208",1208,1080,853,3332,1998,"0089",0,0,0
"1209",1209,259,51,575,317,"0090",18,9,9
"1210",1210,142,94,377,239,"0091A",12,9,3
"1211",1211,1324,920,3682,2327,"0091B",11,10,1
"1212",1212,625,290,1477,949,"0092",0,0,0
"1213",1213,106,95,425,205,"0093",0,0,0
"1214",1214,11,52,83,65,"0094A",0,0,0
"1215",1215,753,737,2295,1547,"0094B",0,0,0
"1216",1216,476,76,1078,558,"0094C",0,0,0
"1217",1217,838,1776,3410,2666,"0095",0,0,0
"1218",1218,420,1694,2653,2154,"0096",8,7,1
"1219",1219,49,272,415,331,"0097",0,0,0
"1220",1220,215,386,846,611,"0098",12,8,4
"1221",1221,821,661,2476,1511,"0099",5,0,5
"1222",1222,978,1045,3200,2097,"0100",0,0,0
"1223",1223,571,352,1599,940,"0101A",82,32,50
"1224",1224,699,514,2132,1272,"0101B",0,0,0
"1225",1225,1700,1128,4473,2916,"0101C",0,0,0
"1226",1226,1289,1346,4111,2717,"0101D",0,0,0
"1227",1227,16,115,162,132,"0102",4,3,1
"1228",1228,161,37,389,198,"0103",0,0,0
"1229",1229,548,701,1758,1279,"0001",2125,1350,775
"1230",1230,1050,1574,3462,2684,"0002",1261,762,499
"1231",1231,342,765,1305,1125,"0003",414,245,169
"1232",1232,0,0,0,0,"0004",1658,806,852
"1233",1233,16,6,47,22,"0005",159,127,32
"1234",1234,10,76,128,91,"0006",674,471,203
"1235",1235,20,70,151,90,"0007",230,175,55
"1236",1236,114,130,364,250,"0008",1325,382,943
"1237",1237,125,143,471,272,"0001",184,102,82
"1238",1238,36,126,230,166,"0002",255,182,73
"1239",1239,149,52,346,206,"0003",273,194,79
"1240",1240,0,2,2,2,"0004",315,270,45
"1241",1241,0,0,0,0,"0006",86,63,23
"1242",1242,1,9,16,10,"0001",1292,97,1195
"1243",1243,50,48,117,98,"0002",1541,356,1185
"1244",1244,96,403,633,506,"0003",944,63,881
"1245",1245,901,779,2656,1742,"0004",1227,103,1124
"1246",1246,1,11,22,12,"003S",325,24,301
"1247",1247,91,43,324,139,"0101",2945,2229,716
"1248",1248,265,275,818,566,"0105",1875,1479,396
"1249",1249,3,18,30,21,"0109",320,285,35
"1250",1250,7,70,92,77,"0113",3236,2214,1022
"1251",1251,12,35,55,48,"0202",1947,1275,672
"1252",1252,457,672,1488,1156,"0204",2651,1349,1302
"1253",1253,426,910,1759,1363,"0212",806,686,120
"1254",1254,909,2022,3453,2975,"0214",949,849,100
"1255",1255,45,120,212,167,"0215",269,244,25
"1256",1256,77,154,353,239,"0303",1713,1157,556
"1257",1257,0,0,0,0,"0306",2144,1756,388
"1258",1258,905,1675,3283,2643,"0307",731,608,123
"1259",1259,397,452,1190,891,"0308",572,509,63
"1260",1260,18,74,118,94,"0316",250,227,23
"1261",1261,9,10,40,19,"0318",2179,1749,430
"1262",1262,566,1408,2593,2020,"0410",2839,2200,639
"1263",1263,719,452,1859,1211,"0411",1950,1072,878
"1264",1264,895,640,2712,1599,"0417",2502,2061,441
"1265",1265,927,1164,2941,2150,"0113",768,563,205
"1266",1266,122,178,546,302,"0114",2328,1328,1000
"1267",1267,29,126,231,156,"0203",444,329,115
"1268",1268,25,35,85,61,"0204",805,627,178
"1269",1269,946,1865,3700,2907,"0207",524,287,237
"1270",1270,19,28,62,50,"0211",1154,797,357
"1271",1271,63,203,337,279,"0215",669,420,249
"1272",1272,1,4,7,5,"0301",1636,1108,528
"1273",1273,0,0,0,0,"0305",609,488,121
"1274",1274,0,0,0,0,"0308",454,357,97
"1275",1275,840,1787,3454,2686,"0309",756,615,141
"1276",1276,6,10,29,16,"0406",1394,671,723
"1277",1277,0,3,6,3,"0410",2370,1813,557
"1278",1278,0,1,3,1,"0001",1570,1324,246
"1279",1279,0,0,0,0,"0002",4405,3089,1316
"1280",1280,0,0,0,0,"0003",2409,1117,1292
"1281",1281,0,0,0,0,"0004",2585,2192,393
"1282",1282,0,0,0,0,"0005",1063,919,144
"1283",1283,0,0,1,0,"0006",603,537,66
"1284",1284,0,0,0,0,"0007",693,602,91
"1285",1285,1,3,4,4,"0008",1337,1061,276
"1286",1286,0,0,2,0,"0009",2745,2110,635
"1287",1287,509,955,1873,1497,"0010",1739,1429,310
"1288",1288,9,16,49,25,"0011",451,413,38
"1289",1289,0,1,1,1,"0012",2157,1625,532
"1290",1290,0,0,0,0,"0013",1459,1005,454
"1291",1291,21,24,71,45,"0014",611,515,96
"1292",1292,480,826,1928,1333,"0015",1008,802,206
"1293",1293,425,404,1337,851,"0016",602,512,90
"1294",1294,156,143,425,305,"0017",1981,1644,337
"1295",1295,541,600,1841,1166,"0018",2022,1361,661
"1296",1296,51,33,160,86,"0019",4416,3569,847
"1297",1297,227,265,732,500,"0020",5127,3438,1689
"1298",1298,68,33,159,102,"0100",518,241,277
"1299",1299,310,157,933,479,"0101",896,372,524
"1300",1300,15,89,155,106,"0102",886,576,310
"1301",1301,18,162,268,182,"0103",2076,1210,866
"1302",1302,17,158,251,180,"0104",557,296,261
"1303",1303,24,198,290,224,"0105",113,35,78
"1304",1304,4,32,61,37,"0107",0,0,0
"1305",1305,389,219,1496,612,"0108",180,46,134
"1306",1306,345,284,1295,633,"0109",37,21,16
"1307",1307,282,182,1064,468,"0110",1182,615,567
"1308",1308,368,262,1331,634,"0111",1429,641,788
"1309",1309,86,51,319,137,"0112",0,0,0
"1310",1310,235,1365,2355,1619,"0113",0,0,0
"1311",1311,172,989,1653,1190,"0114",0,0,0
"1312",1312,17,208,290,228,"0115",5,1,4
"1313",1313,202,1096,1965,1322,"0116",0,0,0
"1314",1314,149,654,1514,815,"0117",0,0,0
"1315",1315,236,755,1942,1008,"0118",125,69,56
"1316",1316,58,567,743,631,"0201",1332,645,687
"1317",1317,50,498,735,555,"0202",1571,811,760
"1318",1318,11,197,257,209,"0203",1533,831,702
"1319",1319,116,524,1082,657,"0204",1663,1068,595
"1320",1320,149,1185,1918,1361,"0205",342,284,58
"1321",1321,53,485,706,548,"0206",1607,567,1040
"1322",1322,30,440,583,474,"0301",2178,769,1409
"1323",1323,15,188,255,206,"0302",2390,740,1650
"1324",1324,145,1082,1779,1246,"0303",1312,516,796
"1325",1325,178,1565,2524,1763,"0305",678,393,285
"1326",1326,139,576,1396,728,"0306",857,210,647
"1327",1327,152,1324,2111,1500,"0307",0,0,0
"1328",1328,64,489,756,556,"0400",69,43,26
"1329",1329,312,1018,2097,1349,"0401",1460,294,1166
"1330",1330,59,241,428,310,"0402",2688,791,1897
"1331",1331,48,329,496,388,"0404",4031,897,3134
"1332",1332,103,226,510,331,"0405",1830,704,1126
"1333",1333,140,652,1097,805,"0407",22,0,22
"1334",1334,69,237,498,313,"0408",24,7,17
"1335",1335,210,817,1447,1043,"0409",33,25,8
"1336",1336,73,359,568,437,"0410",0,0,0
"1337",1337,64,262,457,328,"0411",0,0,0
"1338",1338,104,521,809,637,"0412",410,225,185
"1339",1339,279,482,1317,778,"0001",966,132,834
"1340",1340,263,1110,1923,1389,"0002",1154,186,968
"1341",1341,208,942,1499,1171,"0003",159,15,144
"1342",1342,512,1637,3197,2205,"0004",509,208,301
"1343",1343,269,587,1440,874,"0005",264,152,112
"1344",1344,513,1387,2452,1937,"0006",619,467,152
"1345",1345,226,614,1098,852,"0007",773,221,552
"1346",1346,119,377,689,514,"0008",954,145,809
"1347",1347,117,409,658,535,"0009",88,14,74
"1348",1348,168,795,1276,982,"0010",213,109,104
"1349",1349,424,1657,2817,2122,"0011",800,242,558
"1350",1350,245,970,1612,1255,"0012",1239,832,407
"1351",1351,81,468,421,559,"0013",53,14,39
"1352",1352,273,1075,1854,1380,"0014",236,78,158
"1353",1353,183,635,1209,840,"0015",324,112,212
"1354",1354,62,358,553,432,"0016",1491,581,910
"1355",1355,123,530,864,662,"0017",898,409,489
"1356",1356,76,336,562,419,"0018",473,262,211
"1357",1357,247,1215,1932,1491,"0019",568,457,111
"1358",1358,244,654,1287,910,"0020",193,26,167
"1359",1359,772,2264,4075,3094,"0021",166,101,65
"1360",1360,777,1857,4134,2691,"0022",613,273,340
"1361",1361,251,154,645,416,"0023",307,188,119
"1362",1362,294,195,802,499,"0024",1553,1100,453
"1363",1363,157,322,696,487,"0025",889,748,141
"1364",1364,844,826,2392,1704,"0001",2756,2345,411
"1365",1365,148,294,625,446,"0002",2192,1849,343
"1366",1366,303,200,905,513,"0003",2530,2142,388
"1367",1367,385,411,1300,816,"0004",1539,1418,121
"1368",1368,242,392,1184,647,"0005",125,116,9
"1369",1369,236,527,1269,779,"0006",1038,889,149
"1370",1370,219,631,1335,863,"0007",516,462,54
"1371",1371,251,701,1371,968,"0001",2075,752,1323
"1372",1372,41,186,311,228,"0002",732,299,433
"1373",1373,269,360,1245,633,"0003",3645,209,3436
"1374",1374,264,266,1696,552,"0004",4385,720,3665
"1375",1375,290,285,1727,592,"0005",906,23,883
"1376",1376,329,317,1150,655,"0006",2194,63,2131
"1377",1377,210,313,857,528,"0007",806,39,767
"1378",1378,137,212,532,361,"0008",788,22,766
"1379",1379,232,212,833,450,"0009",4419,209,4210
"1380",1380,204,268,711,478,"0010",2746,48,2698
"1381",1381,347,141,1023,492,"0011",2861,92,2769
"1382",1382,476,275,1396,763,"0012",3493,284,3209
"1383",1383,405,336,1289,755,"0013",1030,22,1008
"1384",1384,138,207,532,355,"0014",4235,146,4089
"1385",1385,342,323,1747,676,"0015",2606,214,2392
"1386",1386,149,321,725,473,"0016",1742,288,1454
"1387",1387,70,293,545,366,"0017",8127,209,7918
"1388",1388,324,359,1443,696,"0018",3530,198,3332
"1389",1389,301,916,1770,1235,"0019",2657,151,2506
"1390",1390,93,129,400,224,"0020",1877,359,1518
"1391",1391,432,969,2295,1427,"0021",3770,233,3537
"1392",1392,56,357,545,417,"0022",3321,157,3164
"1393",1393,144,455,1020,611,"0023",399,55,344
"1394",1394,148,873,1568,1032,"0024",1992,89,1903
"1395",1395,89,646,981,744,"0025",1307,89,1218
"1396",1396,87,658,1081,757,"0026",3826,779,3047
"1397",1397,161,1279,2083,1460,"0027",3324,164,3160
"1398",1398,192,1317,2275,1526,"0028",2133,252,1881
"1399",1399,76,995,1433,1085,"0029",3351,891,2460
"1400",1400,8,86,130,95,"0030",1871,455,1416
"1401",1401,76,599,1016,683,"0031",489,92,397
"1402",1402,39,322,485,364,"0032",4031,753,3278
"1403",1403,95,756,1235,863,"0033",1292,102,1190
"1404",1404,367,380,1238,765,"0034",540,65,475
"1405",1405,153,224,539,386,"0035",1711,367,1344
"1406",1406,1231,1114,4621,2387,"0036",2732,615,2117
"1407",1407,845,778,2497,1658,"0037",2349,57,2292
"1408",1408,877,638,2520,1549,"0038",650,137,513
"1409",1409,324,140,1302,477,"0039",1953,95,1858
"1410",1410,709,573,2188,1316,"0040",3448,546,2902
"1411",1411,153,73,595,233,"0041",6025,259,5766
"1412",1412,863,395,3652,1304,"0042",1857,119,1738
"1413",1413,723,356,3001,1108,"0043",1968,149,1819
"1414",1414,585,366,2267,974,"0044",3642,1202,2440
"1415",1415,804,554,2507,1384,"0045",2879,29,2850
"1416",1416,200,95,757,307,"0046",5110,312,4798
"1417",1417,785,501,2978,1317,"0047",1746,97,1649
"1418",1418,749,417,2111,1199,"0048",5448,401,5047
"1419",1419,181,211,686,401,"0049",1156,180,976
"1420",1420,1111,896,4730,2061,"0050",5640,633,5007
"1421",1421,708,474,2606,1215,"0051",2590,101,2489
"1422",1422,499,371,1775,883,"0052",2204,1456,748
"1423",1423,351,443,1438,805,"0053",6258,120,6138
"1424",1424,272,152,894,434,"0054",5271,261,5010
"1425",1425,777,501,2667,1301,"0055",3737,611,3126
"1426",1426,46,80,275,127,"0056",2909,552,2357
"1427",1427,394,317,1317,754,"0057",1072,115,957
"1428",1428,296,181,864,504,"0058",5113,686,4427
"1429",1429,547,535,1826,1106,"0059",1523,152,1371
"1430",1430,826,488,2754,1345,"0060",1500,133,1367
"1431",1431,578,611,2055,1216,"0061",2975,282,2693
"1432",1432,553,686,1972,1258,"0062",3846,199,3647
"1433",1433,273,384,1163,674,"0063",1805,163,1642
"1434",1434,100,58,262,159,"0064",4052,690,3362
"1435",1435,747,717,2635,1480,"0065",4932,401,4531
"1436",1436,195,134,753,342,"0066",6479,847,5632
"1437",1437,425,553,1722,995,"0067",3840,1601,2239
"1438",1438,339,365,1244,720,"0068",4126,79,4047
"1439",1439,737,609,2134,1367,"0069",5412,159,5253
"1440",1440,664,323,2540,1015,"0070",1694,66,1628
"1441",1441,291,196,665,492,"0071",5304,203,5101
"1442",1442,331,228,1473,574,"0072",4219,218,4001
"1443",1443,723,510,2585,1256,"0073",4889,541,4348
"1444",1444,1287,658,4558,1975,"0074",7218,161,7057
"1445",1445,339,178,1287,528,"0075",4705,90,4615
"1446",1446,326,237,1321,577,"0076",1798,189,1609
"1447",1447,925,1036,2978,2008,"0077",4524,73,4451
"1448",1448,588,345,2310,961,"0078",4738,685,4053
"1449",1449,1260,761,3753,2058,"0079",4972,911,4061
"1450",1450,590,316,1706,929,"0080",6522,1681,4841
"1451",1451,1048,732,2939,1817,"0081",2003,189,1814
"1452",1452,770,676,2460,1470,"0082",4264,254,4010
"1453",1453,543,490,1747,1050,"0083",1340,419,921
"1454",1454,332,283,1547,634,"0084",2315,447,1868
"1455",1455,632,931,2359,1581,"0085",1185,239,946
"1456",1456,1047,617,4425,1732,"0086",2853,107,2746
"1457",1457,1587,987,4334,2622,"0087",2839,755,2084
"1458",1458,982,868,3208,1898,"0088",3950,144,3806
"1459",1459,611,581,2030,1208,"0095",1286,59,1227
"1460",1460,97,60,321,160,"0096",2360,69,2291
"1461",1461,684,722,2434,1428,"0097",645,65,580
"1462",1462,140,144,475,290,"0098",6175,232,5943
"1463",1463,375,236,1379,624,"0099",748,54,694
"1464",1464,843,453,2142,1319,"0100",5137,268,4869
"1465",1465,1048,549,3177,1636,"0101",936,87,849
"1466",1466,638,315,1594,970,"0102",2724,239,2485
"1467",1467,108,113,374,221,"0103",712,68,644
"1468",1468,684,566,2553,1271,"0104",325,31,294
"1469",1469,786,808,2874,1627,"0105",112,1,111
"1470",1470,882,1196,3000,2124,"0106",3559,759,2800
"1471",1471,738,442,2884,1215,"0107",691,41,650
"1472",1472,1002,564,3736,1614,"0108",8,0,8
"1473",1473,378,172,1389,565,"0109",0,0,0
"1474",1474,1048,610,3935,1702,"1001",2319,1291,1028
"1475",1475,1236,808,3291,2080,"2002",2475,1764,711
"1476",1476,1446,857,3720,2345,"3003",2252,1036,1216
"1477",1477,1318,852,4883,2260,"4004",2299,1410,889
"1478",1478,993,543,3457,1580,"0101",515,461,54
"1479",1479,1170,684,3689,1899,"0102",90,79,11
"1480",1480,816,456,3327,1326,"0103",505,376,129
"1481",1481,903,829,3298,1763,"0201",1121,957,164
"1482",1482,956,897,3294,1897,"0301",658,565,93
"1483",1483,885,973,3185,1891,"0302",428,363,65
"1484",1484,533,652,2178,1207,"0401",761,642,119
"1485",1485,592,389,2596,1014,"0402",323,291,32
"1486",1486,530,428,1724,981,"0001",3574,2700,874
"1487",1487,589,586,1880,1196,"0002",416,314,102
"1488",1488,744,828,2465,1600,"0004",484,337,147
"1489",1489,470,322,1696,815,"0005",836,695,141
"1490",1490,565,630,2124,1209,"0006",597,494,103
"1491",1491,929,676,2721,1635,"0007",2487,1922,565
"1492",1492,308,281,893,597,"0009",1150,837,313
"1493",1493,132,150,496,290,"0011",806,549,257
"1494",1494,430,295,1187,733,"0012",1052,761,291
"1495",1495,57,45,197,103,"0014",2360,1955,405
"1496",1496,103,75,376,181,"0015",539,473,66
"1497",1497,383,295,1357,695,"0016",566,470,96
"1498",1498,129,87,397,221,"0017",3735,2984,751
"1499",1499,853,983,3153,1864,"0018",586,523,63
"1500",1500,208,101,564,315,"0019",539,449,90
"1501",1501,1497,923,4638,2487,"0021",340,298,42
"1502",1502,90,81,491,173,"013T",1904,983,921
"1503",1503,1169,804,3111,2005,"020E",256,186,70
"1504",1504,379,229,1238,615,"0101",958,189,769
"1505",1505,341,906,1949,1258,"0105",193,45,148
"1506",1506,298,1195,2215,1496,"0201",1082,183,899
"1507",1507,446,570,1769,1031,"0206",201,133,68
"1508",1508,309,955,1954,1273,"0301",1142,561,581
"1509",1509,35,328,500,372,"0307",319,119,200
"1510",1510,1,58,84,60,"0401",816,130,686
"1511",1511,39,260,469,304,"0408",566,507,59
"1512",1512,75,788,1168,886,"0001",530,402,128
"1513",1513,58,429,673,499,"0002",783,406,377
"1514",1514,20,228,357,250,"0003",557,220,337
"1515",1515,59,488,762,553,"0004",4134,3186,948
"1516",1516,10,200,319,213,"0005",2760,2208,552
"1517",1517,458,1738,3294,2229,"0006",2337,1505,832
"1518",1518,75,239,438,317,"0007",2947,2026,921
"1519",1519,120,429,780,556,"0008",5225,3785,1440
"1520",1520,127,478,804,610,"0009",445,286,159
"1521",1521,40,350,520,392,"0010",5826,4290,1536
"1522",1522,257,1118,2178,1386,"0011",2653,1600,1053
"1523",1523,198,539,1114,749,"0012",1709,973,736
"1524",1524,144,332,764,484,"0013",0,0,0
"1525",1525,173,453,1027,636,"0014",528,302,226
"1526",1526,268,1459,2605,1749,"0015",3030,1287,1743
"1527",1527,37,247,373,286,"0012",1710,1269,441
"1528",1528,37,311,492,348,"0013",1399,1115,284
"1529",1529,314,1746,3046,2081,"0014",1612,1270,342
"1530",1530,28,377,585,413,"0015",4596,2390,2206
"1531",1531,30,321,569,356,"0022",737,478,259
"1532",1532,25,184,280,214,"0023",1025,921,104
"1533",1533,440,569,1776,1028,"0024",2496,1588,908
"1534",1534,24,143,223,168,"0025",1329,1059,270
"1535",1535,117,187,678,309,"0026",1189,667,522
"1536",1536,17,53,165,70,"0027",1136,724,412
"1537",1537,112,237,782,355,"0028",1944,1026,918
"1538",1538,14,86,135,100,"0032",1080,862,218
"1539",1539,113,368,810,485,"0033",2297,1853,444
"1540",1540,12,102,210,118,"0034",1639,1463,176
"1541",1541,63,117,463,187,"0035",1276,806,470
"1542",1542,18,452,605,473,"0036",1916,1452,464
"1543",1543,68,402,620,476,"0037",652,364,288
"1544",1544,150,346,856,501,"0038",1266,287,979
"1545",1545,114,203,494,321,"0042",1726,317,1409
"1546",1546,372,2547,3857,2975,"0043",2006,843,1163
"1547",1547,230,1653,2503,1911,"0044",1690,1212,478
"1548",1548,277,972,1893,1265,"0045",1245,552,693
"1549",1549,231,1283,2406,1528,"0046",851,669,182
"1550",1550,439,2587,4155,3071,"0047",406,296,110
"1551",1551,29,238,392,269,"0048",664,568,96
"1552",1552,167,934,1526,1119,"0101",1182,654,528
"1553",1553,396,1172,2329,1582,"0201",1093,792,301
"1554",1554,261,704,1537,979,"0301",1979,905,1074
"1555",1555,0,0,0,0,"0401",1064,765,299
"1556",1556,126,465,890,598,"0001",1040,922,118
"1557",1557,650,1021,2652,1697,"0006",486,415,71
"1558",1558,215,1310,2076,1546,"0008",841,745,96
"1559",1559,81,498,791,588,"0009",526,469,57
"1560",1560,182,1018,1653,1217,"0010",306,275,31
"1561",1561,156,685,1221,857,"0011",976,864,112
"1562",1562,74,761,1222,839,"0012",366,301,65
"1563",1563,107,901,1404,1021,"0013",144,128,16
"1564",1564,617,1394,3327,2039,"0014",175,160,15
"1565",1565,104,412,758,520,"0015",568,488,80
"1566",1566,80,651,1007,738,"0017",968,906,62
"1567",1567,307,920,1976,1247,"0020",472,444,28
"1568",1568,114,603,1032,721,"0024",362,338,24
"1569",1569,221,484,1074,711,"0026",192,178,14
"1570",1570,184,575,1059,765,"0027",497,411,86
"1571",1571,34,407,618,448,"0032",225,203,22
"1572",1572,110,607,952,721,"0101",518,177,341
"1573",1573,252,1018,1881,1282,"0202",397,226,171
"1574",1574,129,957,1465,1094,"0303",69,40,29
"1575",1575,148,577,1069,732,"0306",447,180,267
"1576",1576,219,1019,1692,1247,"0404",386,86,300
"1577",1577,91,154,444,247,"0001",640,484,156
"1578",1578,120,113,503,241,"0002",656,537,119
"1579",1579,459,149,1259,616,"0003",744,561,183
"1580",1580,261,387,1247,662,"0004",594,454,140
"1581",1581,117,848,1358,969,"0001",1621,1308,313
"1582",1582,140,395,843,536,"0002",1140,893,247
"1583",1583,82,492,759,575,"0003",1452,1119,333
"1584",1584,16,165,281,184,"0004",1553,1342,211
"1585",1585,68,427,629,498,"002E",399,332,67
"1586",1586,97,610,1181,718,"0001",3270,2074,1196
"1587",1587,65,507,901,583,"0002",6248,2965,3283
"1588",1588,53,321,629,379,"0003",4774,940,3834
"1589",1589,95,505,937,610,"0004",2583,1744,839
"1590",1590,103,653,1104,761,"0005",1247,833,414
"1591",1591,44,257,430,307,"0006",1686,712,974
"1592",1592,83,586,942,687,"0007",1809,1027,782
"1593",1593,35,237,389,279,"0008",4333,2545,1788
"1594",1594,24,201,288,232,"0009",4006,2144,1862
"1595",1595,57,616,969,680,"0010",781,583,198
"1596",1596,26,231,337,260,"0011",5089,3409,1680
"1597",1597,18,98,168,117,"0012",2097,1617,480
"1598",1598,13,125,171,138,"0013A",6580,4759,1821
"1599",1599,34,198,358,235,"0013B",0,0,0
"1600",1600,93,663,1027,769,"0014",5905,1453,4452
"1601",1601,18,359,470,382,"0015",2726,1179,1547
"1602",1602,19,241,350,261,"0016",4236,2781,1455
"1603",1603,9,137,181,148,"0017",4425,2656,1769
"1604",1604,29,286,501,321,"0018",1121,803,318
"1605",1605,9,181,246,193,"0019",1617,1216,401
"1606",1606,50,195,436,247,"0020",884,703,181
"1607",1607,40,260,481,304,"0021",4895,2794,2101
"1608",1608,3,56,83,62,"0022",4514,3211,1303
"1609",1609,37,178,388,220,"0023",5638,1569,4069
"1610",1610,47,120,380,167,"0024",3626,1388,2238
"1611",1611,36,392,582,433,"0025",5486,2725,2761
"1612",1612,45,447,629,495,"0026",2949,1333,1616
"1613",1613,51,397,648,453,"0027",3071,1767,1304
"1614",1614,45,342,537,389,"0028",3068,1790,1278
"1615",1615,1,8,13,9,"0029",2798,1988,810
"1616",1616,92,926,1525,1034,"0030",5192,3136,2056
"1617",1617,110,690,1144,811,"0031",2005,1540,465
"1618",1618,92,781,1327,885,"0032",2522,1831,691
"1619",1619,122,980,1534,1124,"0033",4839,3115,1724
"1620",1620,35,264,419,302,"0034",4715,1564,3151
"1621",1621,934,968,2697,1964,"0035",1920,1306,614
"1622",1622,1432,1363,4371,2879,"0036",1795,1366,429
"1623",1623,985,378,2626,1413,"0037",2900,2205,695
"1624",1624,604,1242,2276,1880,"0038",7734,3612,4122
"1625",1625,283,462,1042,759,"0039",3827,1945,1882
"1626",1626,640,477,1531,1139,"0040",3540,2521,1019
"1627",1627,585,539,1570,1151,"0041",4986,3245,1741
"1628",1628,509,1358,2982,1911,"0042",2176,1388,788
"1629",1629,1064,1410,3083,2544,"0043",3989,1874,2115
"1630",1630,96,447,739,555,"0044",2882,1143,1739
"1631",1631,603,2227,4037,2886,"0045",3594,2322,1272
"1632",1632,627,973,2170,1640,"0046",5242,1664,3578
"1633",1633,498,981,1382,1523,"0047",2974,1639,1335
"1634",1634,1411,937,3103,2384,"0048",4798,2967,1831
"1635",1635,626,524,1658,1182,"0049",2301,1800,501
"1636",1636,1048,1857,3772,2985,"0050",5723,1489,4234
"1637",1637,968,1612,3680,2655,"0051",2840,876,1964
"1638",1638,126,503,877,636,"0052",5664,1637,4027
"1639",1639,593,696,1643,1319,"0053",2249,1671,578
"1640",1640,160,488,840,669,"0054",4513,1969,2544
"1641",1641,1726,1512,4275,3327,"0055",8867,4067,4800
"1642",1642,647,2360,3995,3066,"0056",4049,2283,1766
"1643",1643,1332,495,2951,1870,"0057",5760,3329,2431
"1644",1644,1093,488,2478,1625,"0058",4484,2314,2170
"1645",1645,1434,1262,3438,2755,"0059",4289,2648,1641
"1646",1646,478,365,1197,867,"0060",2755,1761,994
"1647",1647,879,1023,2690,1936,"0061",1781,1207,574
"1648",1648,1231,1080,3121,2358,"0062",2817,1749,1068
"1649",1649,708,1340,2466,2081,"0063",1964,1508,456
"1650",1650,1506,1869,4632,3468,"0064",3403,1900,1503
"1651",1651,763,903,2127,1724,"0065",1532,912,620
"1652",1652,921,1029,2548,2006,"0066",2651,1517,1134
"1653",1653,960,2149,4137,3159,"0067",3710,2259,1451
"1654",1654,2027,1334,4359,3441,"0068",2724,1185,1539
"1655",1655,222,921,1585,1154,"0069",4024,2542,1482
"1656",1656,704,887,1984,1624,"0070",1890,1448,442
"1657",1657,265,1415,2300,1712,"0071",1941,1346,595
"1658",1658,1057,976,2613,2079,"0072",2191,1139,1052
"1659",1659,1219,892,3077,2175,"0073",2711,1287,1424
"1660",1660,1057,1614,3603,2749,"0074",2328,1505,823
"1661",1661,980,1822,3427,2858,"0075",2302,1555,747
"1662",1662,324,934,1746,1290,"0076",3881,2357,1524
"1663",1663,1270,1033,3420,2374,"0077",3960,2014,1946
"1664",1664,494,482,1653,1000,"0078",6990,3369,3621
"1665",1665,926,1368,3043,2337,"0079",5151,1865,3286
"1666",1666,1134,755,3044,1939,"0080",3849,2233,1616
"1667",1667,978,888,2632,1919,"0081",3612,2022,1590
"1668",1668,1571,1243,3695,2889,"0082",3365,1900,1465
"1669",1669,792,984,2360,1830,"0083",4474,3071,1403
"1670",1670,1295,638,3106,1987,"0084",3059,1781,1278
"1671",1671,698,361,1735,1079,"0085",3638,1962,1676
"1672",1672,1950,957,4124,2986,"0086",3250,1871,1379
"1673",1673,854,927,2253,1820,"0087",7020,1999,5021
"1674",1674,1452,824,3353,2334,"0088",4359,1203,3156
"1675",1675,1558,863,3608,2487,"0089",3593,1730,1863
"1676",1676,922,1350,3113,2337,"0090",3110,2119,991
"1677",1677,1585,1832,4818,3511,"0091",2963,1798,1165
"1678",1678,1484,1170,3745,2707,"0092",5244,2669,2575
"1679",1679,1274,1578,4028,2942,"0093",315,274,41
"1680",1680,801,1398,2662,2243,"0094",4293,2002,2291
"1681",1681,558,700,1714,1301,"0095",3253,1792,1461
"1682",1682,1044,789,2542,1886,"0096",1657,657,1000
"1683",1683,761,879,2058,1680,"0097",1236,1068,168
"1684",1684,1121,891,2704,2062,"0098",2494,1212,1282
"1685",1685,465,443,1243,925,"0099",385,238,147
"1686",1686,842,744,2199,1632,"0100",69,13,56
"1687",1687,1063,908,2718,2015,"0101",4923,2693,2230
"1688",1688,701,630,2055,1369,"0102",2314,1900,414
"1689",1689,1528,1458,3810,3038,"0103",2098,696,1402
"1690",1690,697,801,1950,1528,"0104",4686,1463,3223
"1691",1691,716,684,1825,1428,"0105",1546,964,582
"1692",1692,572,612,1596,1210,"0106",2158,1308,850
"1693",1693,862,494,1968,1392,"0107",3545,2059,1486
"1694",1694,698,701,1933,1441,"0108",3788,1657,2131
"1695",1695,1043,1089,2699,2175,"0109",4733,2767,1966
"1696",1696,1215,1296,3320,2584,"0110",3098,1818,1280
"1697",1697,1572,1063,3711,2680,"0111",7145,3815,3330
"1698",1698,1964,1226,4193,3270,"0112",3084,1868,1216
"1699",1699,965,854,2717,1848,"0113",4251,2383,1868
"1700",1700,1340,1293,3686,2696,"0114",1501,1115,386
"1701",1701,1167,932,2878,2145,"0115",3294,2182,1112
"1702",1702,1063,943,2992,2047,"0116",4936,2872,2064
"1703",1703,964,1834,3859,2857,"0117",5284,2806,2478
"1704",1704,906,876,2416,1825,"0118",4711,3088,1623
"1705",1705,1344,989,3178,2380,"0119",5235,2931,2304
"1706",1706,1113,1093,2884,2253,"0120",3633,2461,1172
"1707",1707,1421,1164,3142,2619,"0121",3084,906,2178
"1708",1708,1014,312,2270,1351,"0122",4868,3844,1024
"1709",1709,1363,1151,3264,2557,"0123",2477,1407,1070
"1710",1710,1110,1443,3263,2600,"0124",4853,2003,2850
"1711",1711,953,804,2323,1812,"0125",6113,2725,3388
"1712",1712,1368,1133,3752,2552,"0126",4995,2922,2073
"1713",1713,31,170,263,204,"0127",4261,2495,1766
"1714",1714,1864,1359,4056,3289,"0128",4699,3652,1047
"1715",1715,1248,1056,3074,2364,"0129",5293,3022,2271
"1716",1716,405,377,1824,802,"0130",3953,2107,1846
"1717",1717,324,748,1331,1097,"0131",3126,2175,951
"1718",1718,391,550,1318,959,"0132",3425,2066,1359
"1719",1719,114,62,286,183,"0133",3386,1737,1649
"1720",1720,5,7,29,14,"0134",7070,3071,3999
"1721",1721,1420,1414,3849,2905,"0135",5084,1975,3109
"1722",1722,775,1251,2582,2078,"0136",2375,1536,839
"1723",1723,512,355,1372,880,"0137",2338,1262,1076
"1724",1724,1172,430,2719,1635,"0138",1188,982,206
"1725",1725,19,18,54,38,"0139",6404,2529,3875
"1726",1726,690,691,1972,1427,"0140",4699,3542,1157
"1727",1727,1465,1141,3440,2662,"0141",3369,1793,1576
"1728",1728,1325,921,2994,2290,"0142",4187,2079,2108
"1729",1729,1516,1547,4026,3123,"0143",2487,1576,911
"1730",1730,1053,1007,2849,2125,"0144",2881,1674,1207
"1731",1731,763,968,2362,1758,"0145",1726,892,834
"1732",1732,1288,1124,3028,2458,"0146",5469,2820,2649
"1733",1733,1151,1068,3382,2300,"0147",2711,1358,1353
"1734",1734,347,822,1560,1196,"0148",0,0,0
"1735",1735,1291,985,2946,2323,"0149",4416,2730,1686
"1736",1736,1957,1841,4825,3867,"0150",1589,1027,562
"1737",1737,1599,1477,4315,3148,"0151",1976,865,1111
"1738",1738,1431,1802,4396,3317,"0152",740,87,653
"1739",1739,963,931,2390,1928,"0153",5530,2980,2550
"1740",1740,1298,1520,3640,2891,"0154",1246,969,277
"1741",1741,1417,749,2753,2209,"0155",2937,1784,1153
"1742",1742,1432,2496,5088,4031,"0156",3904,2359,1545
"1743",1743,719,785,2006,1528,"0157",4265,1905,2360
"1744",1744,1291,996,3173,2339,"0158",3337,1230,2107
"1745",1745,2238,1546,5084,3868,"0159",4409,1728,2681
"1746",1746,1712,1687,4632,3480,"0160",363,310,53
"1747",1747,1393,1331,3812,2775,"0161",353,267,86
"1748",1748,675,1618,2871,2358,"0162",271,213,58
"1749",1749,1466,1627,4349,3155,"0163",7550,3240,4310
"1750",1750,1639,1264,3718,2956,"0164",1807,1262,545
"1751",1751,866,1367,3079,2287,"0165",875,533,342
"1752",1752,1231,923,2891,2191,"0166",4393,1912,2481
"1753",1753,852,934,2729,1843,"0167",5460,2199,3261
"1754",1754,1502,1282,3685,2835,"0168",1721,1246,475
"1755",1755,1715,1338,4134,3103,"0169",3950,1822,2128
"1756",1756,711,762,1959,1507,"0170",2014,1242,772
"1757",1757,707,808,1971,1544,"0171",7419,3803,3616
"1758",1758,700,818,1983,1570,"0172",4854,3029,1825
"1759",1759,1851,1246,4379,3160,"0173",523,450,73
"1760",1760,1314,2242,4726,3649,"0174",4996,2817,2179
"1761",1761,1437,1167,3310,2678,"0175",1949,1177,772
"1762",1762,1273,1008,2962,2336,"0176",6831,3371,3460
"1763",1763,776,873,2105,1677,"0177",8764,4547,4217
"1764",1764,989,1137,2803,2190,"0178",2843,2021,822
"1765",1765,722,537,1651,1287,"0179",4314,3721,593
"1766",1766,1850,1665,4836,3583,"0180",723,485,238
"1767",1767,775,693,2072,1509,"0181",2846,1685,1161
"1768",1768,131,151,369,289,"0182",0,0,0
"1769",1769,1455,1802,4322,3327,"0183",80,70,10
"1770",1770,538,808,1655,1364,"0184",0,0,0
"1771",1771,738,540,1731,1306,"0185",61,59,2
"1772",1772,95,27,175,122,"0186",139,122,17
"1773",1773,1591,1855,4473,3504,"0187",624,482,142
"1774",1774,172,777,1200,963,"0188",183,104,79
"1775",1775,985,1158,2794,2182,"0189",1042,719,323
"1776",1776,1207,1386,3645,2664,"0190",86,58,28
"1777",1777,1657,1383,3862,3121,"0191",826,440,386
"1778",1778,1228,815,2656,2077,"0192",2753,1922,831
"1779",1779,1195,1004,3226,2264,"0193",1425,1026,399
"1780",1780,39,263,373,311,"0194",24,17,7
"1781",1781,71,129,295,206,"0195",910,703,207
"1782",1782,33,188,271,224,"0196",2187,1227,960
"1783",1783,796,737,1979,1559,"0197",1712,603,1109
"1784",1784,672,717,1641,1413,"0198",140,98,42
"1785",1785,280,441,920,741,"0199",2373,1790,583
"1786",1786,1528,1488,3955,3077,"0200",0,0,0
"1787",1787,2261,1470,4862,3794,"0201",0,0,0
"1788",1788,521,937,1899,1509,"0202",0,0,0
"1789",1789,1267,1125,3155,2445,"0203",2968,2373,595
"1790",1790,532,791,1799,1365,"0204",355,236,119
"1791",1791,908,900,2386,1841,"0205",24,13,11
"1792",1792,1123,2142,4730,3336,"0206",2061,1365,696
"1793",1793,173,299,632,487,"0207",4187,2625,1562
"1794",1794,1376,1684,4246,3141,"0208",2631,1715,916
"1795",1795,577,836,1802,1450,"0209",1275,528,747
"1796",1796,1534,989,4107,2601,"0210",1671,701,970
"1797",1797,781,817,2340,1629,"0211",3554,2224,1330
"1798",1798,568,1442,2665,2039,"0212",5841,1538,4303
"1799",1799,1157,2664,4633,3909,"0213",4330,1736,2594
"1800",1800,1216,1134,3043,2393,"0214",3887,3112,775
"1801",1801,523,934,2061,1495,"0215",2942,1789,1153
"1802",1802,1259,1240,3299,2544,"0216",7075,4841,2234
"1803",1803,11,55,103,67,"0217",2827,1755,1072
"1804",1804,1031,1078,3092,2153,"0218",4483,1897,2586
"1805",1805,16,20,47,37,"0219",4188,2255,1933
"1806",1806,13,84,135,98,"0220",5856,1702,4154
"1807",1807,44,369,545,418,"0221",5024,3617,1407
"1808",1808,5,38,68,45,"0222",4297,1758,2539
"1809",1809,103,467,816,581,"0223",1947,1124,823
"1810",1810,8,48,88,57,"0224",2438,1861,577
"1811",1811,60,252,524,319,"0225",4394,1480,2914
"1812",1812,405,1363,2366,1796,"0226",4796,2698,2098
"1813",1813,148,604,1068,762,"0227",4385,2432,1953
"1814",1814,2,23,35,27,"0228",6148,2720,3428
"1815",1815,165,497,879,684,"0229",1746,883,863
"1816",1816,646,718,1886,1406,"0230",6483,2865,3618
"1817",1817,583,374,1258,975,"0231",4001,2219,1782
"1818",1818,13,84,115,97,"0232",3690,2175,1515
"1819",1819,563,1364,2322,1975,"0233",2184,1250,934
"1820",1820,410,858,1667,1302,"0234",2222,887,1335
"1821",1821,0,0,0,0,"0235",2381,897,1484
"1822",1822,0,0,0,0,"0236",2841,1985,856
"1823",1823,929,1458,3130,2440,"0237",2565,1054,1511
"1824",1824,126,169,350,298,"0238",4900,2102,2798
"1825",1825,10,11,28,21,"0239",4249,2855,1394
"1826",1826,533,745,1694,1312,"0101",519,428,91
"1827",1827,1239,1765,4000,3070,"0201",397,211,186
"1828",1828,701,1188,2249,1936,"0202",70,39,31
"1829",1829,376,407,994,800,"0301",424,250,174
"1830",1830,776,545,1600,1337,"0302",90,73,17
"1831",1831,1111,1279,3250,2452,"0401",387,222,165
"1832",1832,2104,1539,4325,3695,"0402",101,86,15
"1833",1833,1412,1204,3421,2665,"0101",3080,1759,1321
"1834",1834,869,2410,4019,3336,"0102",359,232,127
"1835",1835,386,968,2170,1383,"0103",715,494,221
"1836",1836,1185,2441,4716,3706,"0201",3466,2370,1096
"1837",1837,764,1090,2448,1903,"0202",582,461,121
"1838",1838,1629,1406,3802,3096,"0302",1059,950,109
"1839",1839,1348,1260,3283,2663,"0303",649,589,60
"1840",1840,1701,1359,3946,3106,"0304",563,478,85
"1841",1841,1405,2232,4806,3713,"0305",1947,1406,541
"1842",1842,1329,1196,3173,2576,"0401",412,185,227
"1843",1843,747,786,1917,1569,"0402",3261,1006,2255
"1844",1844,520,1491,2468,2046,"0101",4374,3341,1033
"1845",1845,1614,1169,3671,2827,"0102",4292,3191,1101
"1846",1846,1659,1542,4393,3283,"0103",3832,3096,736
"1847",1847,1583,1564,4161,3241,"0104",2380,1950,430
"1848",1848,1492,1492,4232,3067,"0105",4749,3614,1135
"1849",1849,444,448,1190,913,"0106",5104,3981,1123
"1850",1850,1772,1226,4293,3070,"0107",3134,2335,799
"1851",1851,1001,1168,2867,2217,"0108",2127,1673,454
"1852",1852,1092,1466,3271,2611,"0201",5949,3579,2370
"1853",1853,566,761,1781,1363,"0202A",1560,806,754
"1854",1854,900,705,1947,1634,"0202B",146,118,28
"1855",1855,836,576,1901,1445,"0202C",0,0,0
"1856",1856,869,1330,2768,2246,"0203",5133,3802,1331
"1857",1857,863,734,2164,1628,"0204",4363,2917,1446
"1858",1858,1459,1114,3600,2620,"0205",5292,3584,1708
"1859",1859,996,2098,4085,3175,"0206",6379,4601,1778
"1860",1860,1781,3518,4918,5408,"0207",2180,1710,470
"1861",1861,791,688,1894,1508,"0208",2111,1566,545
"1862",1862,1108,1015,2713,2161,"0301",7936,2788,5148
"1863",1863,351,657,1241,1032,"0302",6417,3829,2588
"1864",1864,1084,883,2400,1997,"0303",1143,486,657
"1865",1865,1042,1314,3219,2401,"0304",6716,3454,3262
"1866",1866,1142,1102,2843,2295,"0305",4148,2362,1786
"1867",1867,489,1181,2084,1714,"0306",4152,2458,1694
"1868",1868,852,716,2091,1603,"0401",2798,2246,552
"1869",1869,42,281,532,332,"0402",5234,4248,986
"1870",1870,34,181,394,219,"0403",6566,5192,1374
"1871",1871,2,37,54,40,"0404",4147,3038,1109
"1872",1872,31,206,393,237,"0405",5556,3985,1571
"1873",1873,5,38,67,43,"0406A",5820,4463,1357
"1874",1874,36,221,400,258,"0406B",5,0,5
"1875",1875,5,84,100,89,"0407",2792,2267,525
"1876",1876,413,1107,2301,1536,"0001",1887,1363,524
"1877",1877,42,170,327,217,"0002",2220,1356,864
"1878",1878,58,382,643,442,"0004",102,94,8
"1879",1879,477,1781,3038,2283,"0005",806,629,177
"1880",1880,58,376,633,439,"0006",391,273,118
"1881",1881,128,792,1150,927,"0007",471,314,157
"1882",1882,63,392,591,464,"0009",246,176,70
"1883",1883,57,357,529,420,"0010",566,457,109
"1884",1884,279,1002,1811,1292,"0011",586,450,136
"1885",1885,125,211,544,341,"0012",2347,1737,610
"1886",1886,720,902,2744,1652,"0013",276,242,34
"1887",1887,1073,1926,3960,3087,"0014",130,114,16
"1888",1888,707,2708,4180,3464,"0015",449,392,57
"1889",1889,810,2610,4156,3478,"0016",89,80,9
"1890",1890,404,1301,2224,1730,"0101",377,330,47
"1891",1891,695,2261,4178,3004,"0102",95,52,43
"1892",1892,597,2363,3600,3008,"0203",115,101,14
"1893",1893,846,2151,3398,3034,"0204",130,81,49
"1894",1894,367,1118,1933,1511,"0205",239,153,86
"1895",1895,271,1089,1661,1384,"0306",396,232,164
"1896",1896,491,1550,2480,2074,"0407",163,145,18
"1897",1897,1071,2063,4369,3190,"0408",1336,791,545
"1898",1898,496,995,2133,1520,"0001",2262,1461,801
"1899",1899,0,0,0,0,"0002",337,226,111
"1900",1900,1048,2962,4905,4076,"0003",559,422,137
"1901",1901,691,2238,3827,2982,"0004",380,327,53
"1902",1902,1295,2780,4997,4129,"0005",2031,1253,778
"1903",1903,704,2262,3626,3017,"0006",611,550,61
"1904",1904,438,1509,2374,1978,"0007",1853,1550,303
"1905",1905,705,2098,3432,2850,"0008",1131,934,197
"1906",1906,18,39,70,58,"0009",1739,1525,214
"1907",1907,4,7,15,12,"0010",1842,1627,215
"1908",1908,1363,1537,5351,2991,"0011",3215,2330,885
"1909",1909,0,0,0,0,"0012",798,707,91
"1910",1910,696,1073,2627,1820,"0014",316,269,47
"1911",1911,365,314,1055,700,"0015",320,294,26
"1912",1912,835,1264,3428,2159,"0017",426,406,20
"1913",1913,826,1697,3468,2584,"0018",1738,1573,165
"1914",1914,666,1086,2695,1796,"0019",487,429,58
"1915",1915,413,639,1722,1083,"0020",415,343,72
"1916",1916,703,1112,2699,1852,"0021",1155,1083,72
"1917",1917,751,1625,3166,2437,"0022",1998,1847,151
"1918",1918,1007,2888,5031,3961,"0026",1184,658,526
"1919",1919,561,1815,2951,2415,"0027",422,305,117
"1920",1920,835,2424,4082,3309,"0028",128,104,24
"1921",1921,776,2824,4874,3652,"0030",390,193,197
"1922",1922,1049,2428,4604,3553,"0031",400,168,232
"1923",1923,611,1929,2974,2578,"0033",517,468,49
"1924",1924,638,2055,3340,2740,"0034",1074,343,731
"1925",1925,134,894,1671,1038,"0035",1782,959,823
"1926",1926,149,936,1816,1098,"0037",2013,1443,570
"1927",1927,10,55,87,68,"0101",7986,4235,3751
"1928",1928,68,418,782,491,"0102",1624,1384,240
"1929",1929,36,231,385,271,"0103",416,321,95
"1930",1930,29,183,329,215,"0104",5351,3067,2284
"1931",1931,15,99,216,115,"0205",2845,2208,637
"1932",1932,43,260,482,310,"0206",3411,1571,1840
"1933",1933,77,328,593,409,"0207",5498,2941,2557
"1934",1934,215,1146,2178,1362,"0308",4794,3965,829
"1935",1935,30,154,277,185,"0309",806,700,106
"1936",1936,16,80,130,97,"0310",967,786,181
"1937",1937,28,318,488,349,"0311",8372,4321,4051
"1938",1938,3,75,99,78,"0412",4814,2723,2091
"1939",1939,37,287,440,328,"0413",10871,5734,5137
"1940",1940,11,56,100,69,"0414",402,362,40
"1941",1941,3,109,130,114,"0415",237,205,32
"1942",1942,16,73,141,90,"0416",4212,2119,2093
"1943",1943,22,109,186,133,"0101",318,232,86
"1944",1944,55,157,316,213,"0201",266,221,45
"1945",1945,1,80,105,81,"0301",246,132,114
"1946",1946,52,187,341,242,"0401",267,179,88
"1947",1947,41,254,397,305,"0001",821,373,448
"1948",1948,439,833,2682,1305,"0002",677,257,420
"1949",1949,61,387,557,454,"0003",906,230,676
"1950",1950,70,295,577,369,"0004",947,270,677
"1951",1951,165,1341,2132,1527,"0001",598,151,447
"1952",1952,154,995,1704,1168,"0002",635,333,302
"1953",1953,87,623,1020,718,"0003",602,314,288
"1954",1954,236,1383,2048,1641,"0004",559,104,455
"1955",1955,315,1488,2620,1831,"0011",836,305,531
"1956",1956,123,767,1141,896,"0027",1032,550,482
"1957",1957,22,347,450,374,"0039",884,380,504
"1958",1958,130,1337,1859,1490,"0044",1060,525,535
"1959",1959,627,1669,3758,2352,"0001",382,59,323
"1960",1960,86,1019,1357,1114,"0002",466,109,357
"1961",1961,257,1416,2039,1704,"0004",474,101,373
"1962",1962,40,316,488,359,"03-3",48,21,27
"1963",1963,357,1126,2346,1512,"03-5",351,106,245
"1964",1964,1262,1686,5487,3030,"0001",533,352,181
"1965",1965,114,871,1392,993,"0002",79,56,23
"1966",1966,30,217,375,250,"0003",32,32,0
"1967",1967,1091,1667,5112,2847,"0004",62,52,10
"1968",1968,272,1329,2388,1624,"0005",36,36,0
"1969",1969,622,649,3636,1324,"0006",586,275,311
"1970",1970,1165,1445,4774,2676,"0007",1137,416,721
"1971",1971,431,2304,4152,2777,"0008",1153,601,552
"1972",1972,54,422,667,482,"0009",1404,554,850
"1973",1973,98,487,811,592,"1000",2143,232,1911
"1974",1974,118,91,955,217,"1001",1840,483,1357
"1975",1975,857,1171,3695,2071,"1002",3272,442,2830
"1976",1976,317,1351,2636,1696,"1003",5297,771,4526
"1977",1977,19,286,401,307,"1004",2000,1113,887
"1978",1978,19,163,264,184,"1005",2779,1452,1327
"1979",1979,1074,1220,4628,2360,"1006",1561,1352,209
"1980",1980,26,156,264,187,"1007",373,320,53
"1981",1981,19,158,256,181,"1008",4097,1959,2138
"1982",1982,31,106,248,137,"1009",3499,489,3010
"1983",1983,37,120,270,160,"1010",3237,991,2246
"1984",1984,56,421,763,487,"1011",2933,361,2572
"1985",1985,80,356,771,440,"1012",682,404,278
"1986",1986,61,243,591,308,"1013",5865,4241,1624
"1987",1987,44,227,536,275,"1014",4223,1713,2510
"1988",1988,113,282,681,396,"1015",4712,3167,1545
"1989",1989,73,331,602,407,"1016",298,228,70
"1990",1990,63,375,627,443,"1017",1647,1262,385
"1991",1991,95,232,558,328,"1018",325,218,107
"1992",1992,104,251,789,357,"1019",3053,2207,846
"1993",1993,151,406,982,572,"1020",1795,1361,434
"1994",1994,128,318,857,457,"1021",1883,1468,415
"1995",1995,144,421,1000,580,"1022",4094,2757,1337
"1996",1996,110,88,453,199,"1023",2058,1650,408
"1997",1997,112,108,419,225,"1026",754,349,405
"1998",1998,90,68,360,159,"1027",6115,1450,4665
"1999",1999,12,19,57,31,"1028",2919,598,2321
"2000",2000,114,132,424,250,"1029",3766,638,3128
"2001",2001,22,223,384,248,"1030",4862,1058,3804
"2002",2002,2,55,77,57,"1032",1438,525,913
"2003",2003,0,24,28,24,"1033",2056,788,1268
"2004",2004,0,29,40,30,"1035",451,95,356
"2005",2005,2,22,33,24,"1036",1987,383,1604
"2006",2006,26,209,465,239,"1037",4801,648,4153
"2007",2007,61,233,626,296,"1038",5966,680,5286
"2008",2008,47,358,799,414,"1039",587,40,547
"2009",2009,37,236,588,278,"1040",5140,1282,3858
"2010",2010,775,525,1717,1334,"1041",1770,225,1545
"2011",2011,708,685,1664,1437,"1042",2954,264,2690
"2012",2012,155,189,405,351,"1043",3195,1700,1495
"2013",2013,151,16,295,169,"1044",2392,1642,750
"2014",2014,1323,510,3058,1868,"1045",5746,901,4845
"2015",2015,363,73,1050,449,"1046",378,168,210
"2016",2016,957,779,2360,1782,"1047",2208,720,1488
"2017",2017,1298,1021,3011,2388,"1048",2741,2044,697
"2018",2018,907,199,2222,1132,"1049",3335,1804,1531
"2019",2019,159,70,339,238,"1050",162,136,26
"2020",2020,628,325,1490,982,"1051",282,192,90
"2021",2021,1281,867,2701,2215,"1052",4315,2590,1725
"2022",2022,867,516,1900,1406,"1054",2972,729,2243
"2023",2023,78,54,159,133,"1055",1829,234,1595
"2024",2024,99,49,222,157,"1056",1491,516,975
"2025",2025,1748,852,3542,2677,"1057",3193,873,2320
"2026",2026,722,240,1635,978,"1058",2733,1216,1517
"2027",2027,344,110,897,468,"1059",1936,1176,760
"2028",2028,442,250,1070,714,"1060",4094,3326,768
"2029",2029,914,357,2059,1306,"1061",1438,1074,364
"2030",2030,1013,441,2107,1491,"1062",78,14,64
"2031",2031,737,500,1690,1262,"1063",2879,584,2295
"2032",2032,2291,1203,4273,3565,"1064",327,33,294
"2033",2033,765,373,1438,1165,"1065A",5342,593,4749
"2034",2034,15,11,57,27,"1065B",0,0,0
"2035",2035,752,280,1766,1066,"1065C",0,0,0
"2036",2036,63,16,173,81,"1067",19,5,14
"2037",2037,1269,308,3088,1608,"1068",91,41,50
"2038",2038,4,4,11,8,"1069",50,17,33
"2039",2039,22,14,52,39,"1070",3244,1069,2175
"2040",2040,23,5,56,28,"1071A",3373,2131,1242
"2041",2041,0,0,0,0,"1071B",0,0,0
"2042",2042,562,107,1373,684,"1073",4539,1330,3209
"2043",2043,929,331,1944,1286,"1074",2387,265,2122
"2044",2044,386,63,1121,456,"1075",2383,1163,1220
"2045",2045,1557,571,2978,2191,"1076",2226,1611,615
"2046",2046,116,19,284,141,"1077",0,0,0
"2047",2047,758,227,1799,1007,"1078",2664,262,2402
"2048",2048,1896,454,3411,2398,"1079",2622,983,1639
"2049",2049,544,152,1379,724,"1080",1815,193,1622
"2050",2050,226,73,597,305,"1081",3643,1537,2106
"2051",2051,1766,260,3416,2066,"1082",867,74,793
"2052",2052,845,223,2252,1102,"1083",3327,443,2884
"2053",2053,1054,119,2218,1197,"1084",3688,868,2820
"2054",2054,1114,230,2365,1377,"1085",2746,190,2556
"2055",2055,924,233,2292,1192,"1086",1159,235,924
"2056",2056,1576,228,3800,1849,"1087A",5249,373,4876
"2057",2057,794,124,1780,934,"1087B",0,0,0
"2058",2058,629,73,1363,715,"1087C",0,0,0
"2059",2059,640,138,1493,795,"1087D",0,0,0
"2060",2060,609,123,1505,741,"1088",4669,577,4092
"2061",2061,1084,281,2723,1390,"1089",3483,159,3324
"2062",2062,941,169,2169,1130,"1090",4024,328,3696
"2063",2063,35,9,76,46,"1091",3919,284,3635
"2064",2064,1311,118,3171,1461,"1092",8964,508,8456
"2065",2065,701,192,1753,910,"1093",2783,127,2656
"2066",2066,780,197,2072,1000,"1094",2545,89,2456
"2067",2067,206,65,521,279,"1095",2459,153,2306
"2068",2068,1173,221,2745,1421,"1096",2844,150,2694
"2069",2069,24,3,43,27,"1097",4872,435,4437
"2070",2070,103,24,249,131,"1098",3344,203,3141
"2071",2071,314,108,842,432,"1099",116,17,99
"2072",2072,1154,222,2667,1400,"1100",4857,127,4730
"2073",2073,175,80,558,262,"1101",3520,199,3321
"2074",2074,13,5,29,19,"1102",4109,331,3778
"2075",2075,604,176,1530,798,"1103",953,87,866
"2076",2076,127,23,269,153,"1104",4796,249,4547
"2077",2077,336,41,835,387,"1105",107,4,103
"2078",2078,667,230,1480,918,"1106",478,25,453
"2079",2079,612,256,1487,891,"1107",1599,142,1457
"2080",2080,893,366,2429,1287,"1108",4548,285,4263
"2081",2081,3,1,6,4,"1109",1462,128,1334
"2082",2082,793,378,2275,1196,"1110",40,0,40
"2083",2083,203,357,669,579,"1111",3223,287,2936
"2084",2084,57,7,157,65,"1112",1059,35,1024
"2085",2085,188,96,363,295,"1113",416,12,404
"2086",2086,248,34,554,289,"1114",1628,95,1533
"2087",2087,734,131,1664,879,"1115",2294,584,1710
"2088",2088,3,0,4,3,"1116",2439,512,1927
"2089",2089,14,12,33,27,"1117",2730,2336,394
"2090",2090,2,6,11,8,"1118",2871,998,1873
"2091",2091,0,0,0,0,"1119",3226,139,3087
"2092",2092,524,481,1280,1045,"1120",1834,1188,646
"2093",2093,1053,1151,2730,2287,"1121",4255,577,3678
"2094",2094,601,645,1508,1279,"1122",856,327,529
"2095",2095,1312,1009,3013,2401,"1124",30,4,26
"2096",2096,944,792,2244,1815,"1125",4215,957,3258
"2097",2097,289,303,751,612,"1126",2699,278,2421
"2098",2098,0,0,0,0,"1127",1841,302,1539
"2099",2099,21,8,51,31,"1128",622,542,80
"2100",2100,24,6,60,31,"1129",618,20,598
"2101",2101,0,0,0,0,"1130",2785,1094,1691
"2102",2102,0,0,0,0,"1131",2296,943,1353
"2103",2103,679,468,1359,1178,"1132",60,28,32
"2104",2104,1013,887,2447,1962,"1133",353,247,106
"2105",2105,1017,729,2038,1801,"1134",792,26,766
"2106",2106,1448,966,2950,2478,"1135",2668,113,2555
"2107",2107,1493,869,2959,2441,"1136",23,8,15
"2108",2108,679,441,1396,1141,"1137",33,7,26
"2109",2109,1307,651,2557,2005,"1138",252,137,115
"2110",2110,970,589,2047,1596,"1139",28,7,21
"2111",2111,553,305,1009,874,"1140",0,0,0
"2112",2112,1332,752,2617,2135,"1141",0,0,0
"2113",2113,0,0,0,0,"1300",4531,1117,3414
"2114",2114,928,624,2680,1591,"1301",4205,1161,3044
"2115",2115,906,642,2619,1586,"1302",3926,1291,2635
"2116",2116,995,502,2579,1537,"1303",336,33,303
"2117",2117,58,3,175,63,"1304",2334,662,1672
"2118",2118,559,413,1616,994,"1305",2831,663,2168
"2119",2119,567,348,1649,937,"1307",618,50,568
"2120",2120,93,6,234,102,"1308A",3685,827,2858
"2121",2121,647,400,2009,1064,"1308B",0,0,0
"2122",2122,178,21,453,200,"1309",979,82,897
"2123",2123,1028,729,3026,1802,"1310",5367,1594,3773
"2124",2124,790,685,2277,1508,"1311",3117,1152,1965
"2125",2125,337,264,1073,614,"1312",1573,462,1111
"2126",2126,194,38,385,237,"1313",431,30,401
"2127",2127,848,484,2495,1360,"1314",3935,826,3109
"2128",2128,17,7,46,25,"1315",41,8,33
"2129",2129,381,108,950,499,"1316",1952,434,1518
"2130",2130,0,0,0,0,"1317",14,4,10
"2131",2131,1059,941,2908,2038,"1500",4657,1297,3360
"2132",2132,922,898,2738,1849,"1501",3045,1598,1447
"2133",2133,538,441,1483,998,"1502",4833,2091,2742
"2134",2134,1266,514,3031,1818,"1503",4013,1084,2929
"2135",2135,8,5,24,13,"1504",1909,1204,705
"2136",2136,5,4,16,9,"1700",3868,858,3010
"2137",2137,130,55,405,187,"1701",3443,989,2454
"2138",2138,948,369,2563,1337,"1702",4652,1125,3527
"2139",2139,5,16,40,21,"1703",5248,968,4280
"2140",2140,357,83,713,451,"1704",2238,513,1725
"2141",2141,171,66,536,239,"1705",3136,790,2346
"2142",2142,191,83,416,281,"1706",6257,870,5387
"2143",2143,1,3,9,4,"1707",3393,224,3169
"2144",2144,1,1,2,2,"1708",1218,477,741
"2145",2145,239,129,706,372,"1709",5462,701,4761
"2146",2146,762,306,2138,1089,"1710",2918,127,2791
"2147",2147,1332,510,3356,1883,"1711",4763,941,3822
"2148",2148,108,108,380,224,"1712",2966,1332,1634
"2149",2149,797,511,2337,1345,"1713",1999,689,1310
"2150",2150,713,557,2144,1290,"1714",3720,978,2742
"2151",2151,1021,727,2971,1785,"1715",3240,492,2748
"2152",2152,1135,674,3091,1859,"1716",2525,1632,893
"2153",2153,552,327,1447,902,"1717",4849,1371,3478
"2154",2154,839,492,2054,1366,"1718",2493,981,1512
"2155",2155,1107,692,3156,1846,"1719",4508,1104,3404
"2156",2156,251,96,884,355,"1720",3786,1452,2334
"2157",2157,273,185,730,466,"1721",2550,1203,1347
"2158",2158,1597,557,3681,2189,"1722",4758,1181,3577
"2159",2159,713,136,1663,876,"1723",413,81,332
"2160",2160,800,471,2317,1310,"1724",254,59,195
"2161",2161,725,696,2156,1454,"1725",553,347,206
"2162",2162,314,382,1205,713,"1726",3707,959,2748
"2163",2163,681,544,2094,1252,"1727",432,112,320
"2164",2164,607,290,1715,919,"1728",2427,694,1733
"2165",2165,690,898,2209,1627,"1729",3107,464,2643
"2166",2166,1297,768,3472,2106,"1730",0,0,0
"2167",2167,522,539,1612,1079,"1731",0,0,0
"2168",2168,1038,587,2761,1675,"2000",44,8,36
"2169",2169,1089,765,2839,1903,"2001",57,7,50
"2170",2170,799,730,2157,1564,"2002",1553,926,627
"2171",2171,1212,568,3211,1816,"2003",2690,1920,770
"2172",2172,76,34,235,116,"2004",1768,1449,319
"2173",2173,50,13,110,67,"2005",987,730,257
"2174",2174,156,220,487,380,"2006",1463,1180,283
"2175",2175,725,482,1939,1242,"2007",2819,2371,448
"2176",2176,103,51,263,158,"2008",1228,1036,192
"2177",2177,493,369,1456,885,"2009",2005,1544,461
"2178",2178,646,338,1669,1007,"2010",1297,1028,269
"2179",2179,0,0,0,0,"2011",1897,1515,382
"2180",2180,0,0,0,0,"2012",1714,1405,309
"2181",2181,518,380,1478,910,"2013",1179,967,212
"2182",2182,1348,954,3627,2361,"2014",478,410,68
"2183",2183,498,498,1452,1025,"2015",2067,980,1087
"2184",2184,1648,1709,4786,3432,"2016",3720,2896,824
"2185",2185,557,852,1794,1434,"2017",3262,1435,1827
"2186",2186,1623,2243,4841,3956,"2018",874,688,186
"2187",2187,1044,800,3135,1889,"2019",1600,1329,271
"2188",2188,1159,897,2972,2117,"2020",2803,2056,747
"2189",2189,1736,1182,4522,2986,"2021",3059,2546,513
"2190",2190,1848,1428,4729,3336,"2022",678,562,116
"2191",2191,1931,1100,4730,3083,"2023",1662,1323,339
"2192",2192,1626,1158,4318,2851,"2024",1991,1496,495
"2193",2193,22,27,83,51,"2025",2654,2346,308
"2194",2194,953,793,2712,1791,"2026",3211,2795,416
"2195",2195,692,435,1782,1143,"2027",1626,1341,285
"2196",2196,1066,872,2820,1988,"2028",3,0,3
"2197",2197,853,510,2192,1398,"2029",1636,1486,150
"2198",2198,1494,954,3808,2493,"2030",2010,1816,194
"2199",2199,1040,1003,3003,2082,"2031",6023,3489,2534
"2200",2200,2076,1583,4830,3745,"2032",3556,1835,1721
"2201",2201,1395,942,3396,2388,"2033",3088,2052,1036
"2202",2202,3,2,12,5,"2034",1727,1454,273
"2203",2203,15,4,26,19,"2035",3262,2046,1216
"2204",2204,631,382,1333,1039,"2036",2631,2022,609
"2205",2205,1178,1042,2728,2260,"2037",2168,1778,390
"2206",2206,774,792,1938,1605,"2038",3886,3078,808
"2207",2207,463,341,1035,833,"2039",3076,2410,666
"2208",2208,673,597,1544,1302,"2040",1628,1408,220
"2209",2209,1198,1310,3023,2571,"2041",6152,3901,2251
"2210",2210,571,621,1439,1227,"2042",2961,2256,705
"2211",2211,931,697,2067,1700,"2043",2125,1669,456
"2212",2212,646,586,1486,1267,"2044",1712,879,833
"2213",2213,860,851,2116,1751,"2045",2096,1463,633
"2214",2214,456,377,1186,850,"2046",1730,1412,318
"2215",2215,1229,1472,3348,2755,"2047",2406,1817,589
"2216",2216,951,381,2062,1367,"2048",7069,3367,3702
"2217",2217,392,380,926,791,"2049",1818,1194,624
"2218",2218,730,731,1774,1497,"2050",2381,1245,1136
"2219",2219,1212,748,2503,2012,"2051",2531,1849,682
"2220",2220,1332,1626,3632,3036,"2052",1287,1065,222
"2221",2221,342,305,742,658,"2053",5046,1582,3464
"2222",2222,557,469,1321,1052,"2054",6039,1643,4396
"2223",2223,768,625,1736,1417,"2055",4004,852,3152
"2224",2224,986,1229,2721,2277,"2056",1341,1101,240
"2225",2225,989,1485,3043,2518,"2057",519,405,114
"2226",2226,556,775,1650,1366,"2058",1411,753,658
"2227",2227,1,0,1,1,"2059",1409,917,492
"2228",2228,569,1235,2177,1845,"2060",3087,2163,924
"2229",2229,1928,968,4145,2990,"2061",3133,2219,914
"2230",2230,1087,472,2283,1618,"2062",2458,2060,398
"2231",2231,1012,660,2225,1718,"2063",706,594,112
"2232",2232,906,517,2046,1462,"2064",2628,1359,1269
"2233",2233,548,541,1438,1110,"2065",2859,1986,873
"2234",2234,1673,1016,3468,2750,"2066",1599,1338,261
"2235",2235,1473,853,3070,2399,"2067",1557,1176,381
"2236",2236,847,570,1747,1470,"2068",2853,1915,938
"2237",2237,1700,1826,4611,3601,"2069",2956,2514,442
"2238",2238,1459,994,3045,2511,"2070",1369,1126,243
"2239",2239,1029,722,2114,1793,"2071",1872,1665,207
"2240",2240,454,350,1093,827,"2072",2864,2332,532
"2241",2241,943,621,1977,1597,"2073",1004,860,144
"2242",2242,731,725,1810,1508,"2074",1597,562,1035
"2243",2243,991,896,2408,1951,"2076",11,6,5
"2244",2244,2021,1072,4574,3174,"2077",1618,985,633
"2245",2245,704,552,1660,1287,"2078",117,22,95
"2246",2246,701,564,1735,1295,"2079",4472,1118,3354
"2247",2247,1052,884,2519,1996,"2200",1665,1484,181
"2248",2248,498,662,1398,1191,"2201",1734,1538,196
"2249",2249,1275,493,2893,1807,"2202",1744,1478,266
"2250",2250,1308,464,2892,1808,"2203",1535,1311,224
"2251",2251,660,260,1670,939,"2220",1578,1397,181
"2252",2252,513,600,1360,1136,"2221",3076,2767,309
"2253",2253,209,256,558,474,"2222",2577,2254,323
"2254",2254,526,344,1186,897,"2223",1597,1279,318
"2255",2255,492,232,1062,738,"2224",5255,3495,1760
"2256",2256,0,3,11,3,"2225",1698,1408,290
"2257",2257,538,548,1386,1103,"2226",2606,2251,355
"2258",2258,1022,287,2124,1339,"2300",1979,566,1413
"2259",2259,98,60,275,159,"2301",2569,1847,722
"2260",2260,290,37,682,330,"2302",3129,664,2465
"2261",2261,1392,370,3002,1811,"2303",3355,1404,1951
"2262",2262,873,400,1776,1320,"2305",5658,2575,3083
"2263",2263,270,49,496,326,"2306",1667,789,878
"2264",2264,146,49,294,202,"2307",992,437,555
"2265",2265,1598,625,2959,2274,"2308",1508,556,952
"2266",2266,1538,571,2907,2162,"2309",3397,990,2407
"2267",2267,22,13,54,36,"2310",2588,1425,1163
"2268",2268,345,274,889,632,"2311",1644,144,1500
"2269",2269,0,0,0,0,"2312",380,64,316
"2270",2270,495,207,986,715,"2400",212,143,69
"2271",2271,0,0,1,0,"2401",4095,2336,1759
"2272",2272,0,0,0,0,"2402",4448,1584,2864
"2273",2273,0,0,0,0,"2403",20,3,17
"2274",2274,840,458,1717,1320,"2404",3334,920,2414
"2275",2275,2152,692,3912,2894,"2405",4109,2284,1825
"2276",2276,0,0,0,0,"2406",4867,2127,2740
"2277",2277,2092,570,3778,2717,"2407",6235,1856,4379
"2278",2278,748,449,1570,1220,"2408",4202,896,3306
"2279",2279,2066,1301,4902,3452,"2409",4005,656,3349
"2280",2280,555,137,1166,711,"2410",3105,1196,1909
"2281",2281,142,122,483,279,"2411",1902,187,1715
"2282",2282,1309,506,2572,1870,"2500",4338,2457,1881
"2283",2283,1076,255,1959,1372,"2501",3699,2705,994
"2284",2284,26,8,47,35,"2502",1723,1475,248
"2285",2285,314,211,795,541,"2503",2426,2105,321
"2286",2286,0,0,0,0,"2504",1598,1097,501
"2287",2287,206,39,543,250,"2505",3693,2206,1487
"2288",2288,18,6,41,25,"2506",2186,1589,597
"2289",2289,74,24,138,98,"2507",2331,1734,597
"2290",2290,0,0,1,0,"2508",5593,2380,3213
"2291",2291,1171,867,2595,2071,"2509",2999,2150,849
"2292",2292,115,98,286,216,"2510",2115,1166,949
"2293",2293,66,42,159,110,"2511",2306,1324,982
"2294",2294,1037,232,2002,1298,"2512",1758,998,760
"2295",2295,650,82,1566,751,"2513",3298,1443,1855
"2296",2296,184,146,477,341,"2514",3503,1772,1731
"2297",2297,954,449,2507,1437,"2601",4539,958,3581
"2298",2298,572,81,1465,669,"2602",4986,1301,3685
"2299",2299,713,307,1631,1040,"2603",5974,1205,4769
"2300",2300,791,242,1901,1053,"2604",4643,1440,3203
"2301",2301,1018,239,2849,1282,"2605",3195,460,2735
"2302",2302,1834,197,3595,2081,"2606",0,0,0
"2303",2303,348,126,646,482,"2700",3884,1687,2197
"2304",2304,1707,722,4012,2480,"2701",7232,3734,3498
"2305",2305,1174,543,2466,1768,"2702",4838,3165,1673
"2306",2306,252,89,770,355,"2703",2309,586,1723
"2307",2307,594,211,1676,822,"2704",5455,1751,3704
"2308",2308,934,204,1906,1169,"2705",3074,920,2154
"2309",2309,390,127,894,535,"2706",4533,1674,2859
"2310",2310,92,114,258,211,"2707",5498,1703,3795
"2311",2311,515,214,1024,744,"2708",6043,2666,3377
"2312",2312,591,127,1453,732,"2709",1867,915,952
"2313",2313,371,78,886,459,"2710",3511,1329,2182
"2314",2314,327,74,912,408,"2711",4408,1699,2709
"2315",2315,368,107,1021,484,"2712",5813,1696,4117
"2316",2316,400,89,904,510,"2713",1944,1240,704
"2317",2317,571,144,1261,733,"2714",6285,1653,4632
"2318",2318,210,109,443,328,"2715",3536,1369,2167
"2319",2319,763,435,1566,1249,"2716",2404,670,1734
"2320",2320,1590,797,3343,2436,"2717A",10,3,7
"2321",2321,1245,490,2847,1791,"2717B",0,0,0
"2322",2322,1018,554,2027,1623,"2717C",0,0,0
"2323",2323,419,111,886,546,"2800",0,0,0
"2324",2324,963,289,1907,1282,"2801",3601,2292,1309
"2325",2325,699,146,1534,874,"2802",4930,2645,2285
"2326",2326,142,73,274,216,"2803",1180,951,229
"2327",2327,855,309,2015,1180,"2804",2614,1570,1044
"2328",2328,661,251,1520,929,"2805",4207,2248,1959
"2329",2329,15,9,48,24,"2806",3211,1670,1541
"2330",2330,1240,457,2204,1753,"2807A",2812,1511,1301
"2331",2331,540,976,1854,1551,"2807B",0,0,0
"2332",2332,552,982,1900,1561,"2808",3730,1662,2068
"2333",2333,570,1015,1939,1627,"2809",4373,1834,2539
"2334",2334,545,802,1613,1388,"2810A",56,30,26
"2335",2335,432,1096,1835,1559,"2810B",0,0,0
"2336",2336,967,2011,3577,3063,"2900",3787,2243,1544
"2337",2337,852,1624,3026,2552,"2901",3559,1293,2266
"2338",2338,566,778,1609,1390,"2902",3127,1304,1823
"2339",2339,765,734,2127,1529,"2903",4040,2426,1614
"2340",2340,541,889,1759,1466,"2904",38,6,32
"2341",2341,843,1492,2859,2393,"2905",455,376,79
"2342",2342,611,320,1432,959,"2910",228,70,158
"2343",2343,868,1005,2401,1917,"2911",673,163,510
"2344",2344,919,328,2033,1273,"2920",4547,2029,2518
"2345",2345,1002,739,2589,1802,"2921",5592,2632,2960
"2346",2346,1007,718,2428,1773,"2922",6449,3306,3143
"2347",2347,578,448,1404,1063,"2923",4250,2231,2019
"2348",2348,315,216,717,541,"2924",2749,1309,1440
"2349",2349,624,301,1131,940,"2925",3306,1986,1320
"2350",2350,864,372,1815,1269,"2926",4073,2058,2015
"2351",2351,871,798,2238,1699,"2927",6810,3076,3734
"2352",2352,182,92,599,282,"2928",2919,1938,981
"2353",2353,31,8,78,42,"2929",1657,908,749
"2354",2354,0,0,0,0,"2940",1820,1176,644
"2355",2355,99,71,239,175,"2941",6189,2969,3220
"2356",2356,617,435,1475,1079,"2942",6419,3430,2989
"2357",2357,47,88,209,139,"3000",5260,3858,1402
"2358",2358,1352,1175,3412,2601,"3001",824,58,766
"2359",2359,1307,958,3342,2328,"3002",2460,126,2334
"2360",2360,1,3,5,4,"3003",2367,230,2137
"2361",2361,822,484,2115,1348,"3004",2156,609,1547
"2362",2362,1265,1172,3245,2500,"3005",1831,1070,761
"2363",2363,1496,886,3397,2430,"3006",5838,4198,1640
"2364",2364,1611,1066,4133,2745,"3007",2345,1729,616
"2365",2365,705,374,1778,1109,"3008",9590,5115,4475
"2366",2366,924,478,2376,1438,"3009",2850,1678,1172
"2367",2367,741,373,1801,1137,"3010",703,343,360
"2368",2368,299,125,806,436,"3011",2524,1456,1068
"2369",2369,2,1,5,3,"3012",272,11,261
"2370",2370,131,121,334,258,"3013",2276,431,1845
"2371",2371,551,360,1301,943,"3014",7435,1360,6075
"2372",2372,559,557,1427,1167,"3015",517,163,354
"2373",2373,657,890,1863,1586,"3016A",2490,1018,1472
"2374",2374,1001,1164,2641,2225,"3016B",0,0,0
"2375",2375,517,489,1432,1064,"3017",1124,186,938
"2376",2376,954,682,2360,1686,"3018",2135,87,2048
"2377",2377,961,819,2310,1863,"3019",1157,57,1100
"2378",2378,908,783,2228,1749,"3020",289,134,155
"2379",2379,1562,784,3649,2442,"3021",1390,35,1355
"2380",2380,1177,1102,3004,2365,"3022",2593,55,2538
"2381",2381,764,544,1884,1344,"3023",1506,31,1475
"2382",2382,858,664,2116,1571,"3024",2221,36,2185
"2383",2383,615,511,1527,1166,"3025",868,2,866
"2384",2384,1169,822,2855,2052,"3026",1090,19,1071
"2385",2385,1150,892,2823,2089,"3027",1443,20,1423
"2386",2386,305,211,741,527,"3028",1272,28,1244
"2387",2387,1304,423,2686,1771,"3029",1329,31,1298
"2388",2388,840,618,1922,1506,"3030",24,8,16
"2389",2389,1103,487,2421,1639,"3031",1781,297,1484
"2390",2390,1737,785,3715,2592,"3032",2401,315,2086
"2391",2391,1033,595,2274,1683,"3033",782,42,740
"2392",2392,648,414,1538,1107,"3034",1826,76,1750
"2393",2393,977,429,2167,1442,"3035",2297,55,2242
"2394",2394,1561,653,3173,2252,"3036",68,7,61
"2395",2395,1605,746,3297,2399,"3037",547,21,526
"2396",2396,1411,635,2958,2091,"3038",956,45,911
"2397",2397,1477,647,2661,2152,"3039",2474,47,2427
"2398",2398,1088,583,2381,1710,"3040",2639,102,2537
"2399",2399,3,0,6,3,"3041",617,24,593
"2400",2400,1119,866,2668,2026,"3042",1864,13,1851
"2401",2401,2,0,4,2,"3043",2569,44,2525
"2402",2402,0,0,0,0,"3044",3764,74,3690
"2403",2403,758,351,1649,1132,"3045",721,24,697
"2404",2404,431,335,1021,779,"3046",3247,436,2811
"2405",2405,1896,991,4029,2950,"3047",4070,433,3637
"2406",2406,53,25,100,78,"3048",2840,113,2727
"2407",2407,0,0,1,0,"3049",2224,41,2183
"2408",2408,1281,1399,3462,2759,"3050",2845,79,2766
"2409",2409,1775,1735,4614,3598,"3051",945,31,914
"2410",2410,453,620,1334,1112,"3052",3287,84,3203
"2411",2411,916,1054,2547,2015,"3053",4410,208,4202
"2412",2412,1745,1604,4315,3440,"3054",2390,103,2287
"2413",2413,977,986,2551,2011,"3055",2041,189,1852
"2414",2414,1095,851,2536,2003,"3056",2037,159,1878
"2415",2415,1296,1271,3205,2617,"3057",3375,183,3192
"2416",2416,1286,940,3145,2275,"3058",2238,39,2199
"2417",2417,5,17,29,22,"3059",1150,31,1119
"2418",2418,1269,1128,3291,2449,"3060",1252,19,1233
"2419",2419,701,319,1727,1045,"3061",2070,48,2022
"2420",2420,905,422,2102,1355,"3062",3818,69,3749
"2421",2421,1348,699,3039,2111,"3063",5020,178,4842
"2422",2422,2,3,13,5,"3064",2521,55,2466
"2423",2423,166,240,489,413,"3065",2773,65,2708
"2424",2424,11,16,66,29,"3066",3159,61,3098
"2425",2425,102,105,320,211,"3067",4673,181,4492
"2426",2426,4,3,14,9,"3068",4467,132,4335
"2427",2427,70,30,170,102,"3069",1816,49,1767
"2428",2428,1789,1176,4580,3054,"3070",2900,86,2814
"2429",2429,246,28,546,277,"3071",2502,58,2444
"2430",2430,450,83,955,547,"3072",120,8,112
"2431",2431,1081,136,1853,1236,"3073",186,3,183
"2432",2432,1209,247,1971,1480,"3074",1465,89,1376
"2433",2433,322,166,709,492,"3075",254,22,232
"2434",2434,1781,1362,4591,3215,"3076",0,0,0
"2435",2435,653,502,1727,1178,"3077",3773,557,3216
"2436",2436,549,205,1443,767,"3078",3567,385,3182
"2437",2437,0,0,0,0,"3079",1596,271,1325
"2438",2438,269,51,560,323,"3080",2318,363,1955
"2439",2439,688,282,1819,992,"3081",1813,1413,400
"2440",2440,67,21,163,88,"3082",5067,213,4854
"2441",2441,342,125,925,479,"3083",2948,547,2401
"2442",2442,891,465,2699,1380,"3084",1768,615,1153
"2443",2443,87,64,282,153,"3086",5458,3977,1481
"2444",2444,925,202,2002,1156,"3087",0,0,0
"2445",2445,343,37,874,391,"3088",117,19,98
"2446",2446,868,62,1897,942,"3089",104,72,32
"2447",2447,369,14,928,389,"3090",2041,1125,916
"2448",2448,133,29,249,166,"3091",0,0,0
"2449",2449,424,33,1167,463,"3092",2555,96,2459
"2450",2450,800,38,2026,857,"3093",39,3,36
"2451",2451,599,24,1325,633,"3094",28,14,14
"2452",2452,649,35,1641,693,"3095",0,0,0
"2453",2453,93,6,199,102,"3096",0,0,0
"2454",2454,359,12,888,379,"3097",146,10,136
"2455",2455,622,31,1363,666,"3098",312,3,309
"2456",2456,473,24,1002,510,"3099",356,10,346
"2457",2457,421,28,935,463,"3100",2530,474,2056
"2458",2458,7,2,19,9,"3101",809,175,634
"2459",2459,287,119,808,412,"3102",4008,571,3437
"2460",2460,547,73,1314,632,"3103",3517,444,3073
"2461",2461,165,17,519,188,"3104",5414,905,4509
"2462",2462,714,44,1455,767,"3105",2740,669,2071
"2463",2463,680,51,1603,740,"3106",4310,634,3676
"2464",2464,6,5,41,11,"3107",2846,295,2551
"2465",2465,183,18,427,205,"3108",2775,1170,1605
"2466",2466,494,17,865,518,"3109",3845,1714,2131
"2467",2467,1111,57,2163,1186,"3110",3315,367,2948
"2468",2468,564,40,1525,620,"3111",0,0,0
"2469",2469,77,5,206,85,"3112",48,8,40
"2470",2470,672,25,1552,706,"3113",19,0,19
"2471",2471,930,44,2066,995,"3114",0,0,0
"2472",2472,1192,63,2753,1282,"3200",2258,928,1330
"2473",2473,320,25,611,355,"3201",2108,759,1349
"2474",2474,1281,183,2421,1499,"3202",2572,513,2059
"2475",2475,750,249,2058,1029,"3203",2567,644,1923
"2476",2476,1289,64,2469,1375,"3204",3718,849,2869
"2477",2477,1038,50,1997,1104,"3205",2182,125,2057
"2478",2478,822,71,1962,913,"3206",2605,1053,1552
"2479",2479,386,21,871,420,"3207",3754,976,2778
"2480",2480,1204,56,2803,1298,"3208",3219,667,2552
"2481",2481,1306,113,2823,1442,"3209",189,74,115
"2482",2482,1670,76,2544,1766,"3210",2863,836,2027
"2483",2483,1484,121,2227,1626,"3211",2162,377,1785
"2484",2484,1474,94,2221,1604,"3300",3727,1591,2136
"2485",2485,1315,156,2607,1494,"3301",3414,1570,1844
"2486",2486,1245,59,2176,1327,"3302",1831,752,1079
"2487",2487,782,25,1252,813,"3303",5041,1278,3763
"2488",2488,867,28,1477,908,"3304",4124,1628,2496
"2489",2489,794,35,1718,849,"3305",5297,1798,3499
"2490",2490,1274,67,3093,1362,"3306",3169,953,2216
"2491",2491,1972,139,4009,2147,"3307",3695,935,2760
"2492",2492,1519,78,2505,1625,"3308",3643,955,2688
"2493",2493,1214,62,2375,1297,"3309",2950,1125,1825
"2494",2494,1100,54,2154,1180,"3310",4151,1671,2480
"2495",2495,1331,73,3058,1431,"3311",3396,1356,2040
"2496",2496,2162,129,3890,2341,"3312",3671,1198,2473
"2497",2497,944,41,1848,1008,"3313",6105,1478,4627
"2498",2498,1655,86,3129,1777,"3314",4543,1022,3521
"2499",2499,1319,76,2600,1430,"3315",3030,704,2326
"2500",2500,27,3,82,30,"3316",3357,1114,2243
"2501",2501,95,7,190,104,"3317",2927,613,2314
"2502",2502,285,79,778,372,"3318",1738,505,1233
"2503",2503,90,12,201,106,"3400",996,185,811
"2504",2504,0,0,0,0,"3401",31,4,27
"2505",2505,1678,438,3167,2160,"3402",907,152,755
"2506",2506,1538,279,3059,1872,"3404",5139,1027,4112
"2507",2507,195,115,669,314,"3405",5014,976,4038
"2508",2508,495,222,1304,733,"3406",77,24,53
"2509",2509,776,484,1736,1289,"3407",661,194,467
"2510",2510,1313,115,3233,1467,"3408",3485,588,2897
"2511",2511,459,210,1258,685,"3409",1329,228,1101
"2512",2512,728,139,1296,888,"3410",874,111,763
"2513",2513,169,73,463,250,"3411",18,3,15
"2514",2514,1755,1139,4355,2943,"3500",5742,2925,2817
"2515",2515,0,0,0,0,"3501",9,2,7
"2516",2516,25,10,45,35,"3600",3368,496,2872
"2517",2517,20,40,78,60,"3601",1970,416,1554
"2518",2518,835,224,1624,1086,"3602",590,70,520
"2519",2519,0,0,0,0,"3603",235,68,167
"2520",2520,806,64,1702,887,"3604",3322,509,2813
"2521",2521,7,0,14,7,"3605",3772,445,3327
"2522",2522,1,0,1,1,"3606",2919,227,2692
"2523",2523,1133,429,2997,1597,"3607",3876,304,3572
"2524",2524,1293,484,3407,1814,"3608",3285,131,3154
"2525",2525,99,1,165,100,"3609",3572,537,3035
"2526",2526,144,4,267,149,"3610",622,154,468
"2527",2527,144,9,334,158,"3611",1287,352,935
"2528",2528,1,0,3,1,"3612",3310,392,2918
"2529",2529,0,0,0,0,"3613",790,192,598
"2530",2530,0,0,0,0,"3614",1067,91,976
"2531",2531,3,1,12,5,"3615",3123,257,2866
"2532",2532,0,0,0,0,"3616",918,72,846
"2533",2533,1302,379,2373,1715,"3617",2856,158,2698
"2534",2534,466,159,786,629,"3618",606,38,568
"2535",2535,1579,319,3194,1938,"3619",699,142,557
"2536",2536,1787,349,3105,2176,"3620",1428,141,1287
"2537",2537,1506,380,2714,1908,"3621",0,0,0
"2538",2538,1322,481,2540,1834,"3700",6849,1942,4907
"2539",2539,2005,457,3776,2517,"3701",5256,2031,3225
"2540",2540,1596,237,2618,1862,"3702",5013,1991,3022
"2541",2541,1028,703,2446,1777,"3703",64,27,37
"2542",2542,1591,1176,3724,2827,"3800",5152,215,4937
"2543",2543,1855,307,3117,2204,"3801",922,93,829
"2544",2544,1,6,12,7,"3802",4727,375,4352
"2545",2545,19,6,32,25,"3803",4769,239,4530
"2546",2546,5,0,6,5,"3805",5730,262,5468
"2547",2547,2,2,6,4,"3806",1210,45,1165
"2548",2548,1283,321,2330,1632,"3807",2756,333,2423
"2549",2549,5,1,9,6,"3808",5515,1377,4138
"2550",2550,46,12,89,59,"3809",506,72,434
"2551",2551,0,0,0,0,"3900",8042,1121,6921
"2552",2552,0,0,0,0,"3920",5726,2785,2941
"2553",2553,0,0,0,0,"3921",8336,2625,5711
"2554",2554,1028,667,2217,1730,"3922",105,0,105
"2555",2555,730,508,1827,1270,"3940A",4447,875,3572
"2556",2556,1129,382,2205,1547,"3940B",0,0,0
"2557",2557,991,407,2045,1417,"3950",5581,1422,4159
"2558",2558,1101,541,2715,1685,"4000",1455,179,1276
"2559",2559,1114,155,1898,1292,"4001",2576,277,2299
"2560",2560,1018,733,2382,1786,"4002",1204,673,531
"2561",2561,1132,673,2813,1852,"4003A",3057,215,2842
"2562",2562,797,368,2003,1186,"4003B",0,0,0
"2563",2563,75,61,195,140,"4004",2783,687,2096
"2564",2564,933,525,2183,1493,"4005",1995,462,1533
"2565",2565,532,216,1409,771,"4006A",1434,768,666
"2566",2566,0,0,0,0,"4006B",0,0,0
"2567",2567,0,0,0,0,"4007",198,107,91
"2568",2568,0,0,0,0,"4008",4781,131,4650
"2569",2569,0,0,0,0,"4009A",3085,174,2911
"2570",2570,0,0,0,0,"4009B",0,0,0
"2571",2571,1052,873,2985,1966,"4010",1501,872,629
"2572",2572,1577,1228,4279,2863,"4011",1237,249,988
"2573",2573,601,423,1907,1040,"4012",98,46,52
"2574",2574,757,386,2176,1164,"4013",334,259,75
"2575",2575,772,482,2333,1285,"4014",1872,1524,348
"2576",2576,819,581,2190,1426,"4015",2033,610,1423
"2577",2577,875,816,2999,1738,"4016",2057,639,1418
"2578",2578,741,744,2546,1511,"4017",531,353,178
"2579",2579,1334,847,3280,2235,"4018",1418,916,502
"2580",2580,1637,678,3409,2353,"4019",4301,1258,3043
"2581",2581,1677,734,3550,2439,"4020",1875,459,1416
"2582",2582,572,281,1747,873,"4021",6214,2686,3528
"2583",2583,1136,792,2914,1953,"4022",5880,1568,4312
"2584",2584,987,371,1993,1379,"4023",141,61,80
"2585",2585,704,392,1623,1114,"4024",3035,203,2832
"2586",2586,41,17,86,59,"4025",625,14,611
"2587",2587,0,0,0,0,"4026",293,20,273
"2588",2588,970,401,2046,1406,"4027",543,7,536
"2589",2589,1,0,4,2,"4028",1566,42,1524
"2590",2590,9,7,34,20,"4029",61,6,55
"2591",2591,1014,1786,3591,2850,"4030",40,1,39
"2592",2592,2,6,7,8,"4031",3152,122,3030
"2593",2593,374,662,1331,1057,"4032",5009,2982,2027
"2594",2594,187,331,666,528,"4033",6896,2740,4156
"2595",2595,1378,256,2364,1668,"4035",1561,372,1189
"2596",2596,1324,288,2032,1634,"4036",1471,59,1412
"2597",2597,430,79,632,520,"4037",276,26,250
"2598",2598,172,44,271,218,"4038",2696,261,2435
"2599",2599,1644,365,2835,2042,"4039",1201,33,1168
"2600",2600,1379,230,2450,1643,"4040",1004,24,980
"2601",2601,1551,160,2592,1752,"4041",1258,42,1216
"2602",2602,2714,326,3940,3080,"4043",2043,75,1968
"2603",2603,2306,157,3249,2494,"4044",2157,36,2121
"2604",2604,2004,372,3303,2413,"4046",2131,30,2101
"2605",2605,278,107,589,392,"4047",1309,11,1298
"2606",2606,600,209,1155,823,"4048",8,0,8
"2607",2607,1980,304,3207,2331,"4049",0,0,0
"2608",2608,358,123,729,489,"4050",5096,808,4288
"2609",2609,601,67,986,675,"4051",28,7,21
"2610",2610,1649,198,2633,1866,"4052",7569,1010,6559
"2611",2611,397,53,724,459,"4053",695,97,598
"2612",2612,1690,123,2563,1830,"4054",1079,30,1049
"2613",2613,375,39,518,418,"4055",4915,311,4604
"2614",2614,106,56,339,167,"4056",5640,338,5302
"2615",2615,886,127,1371,1026,"4057",2427,174,2253
"2616",2616,405,71,712,479,"4058",1751,144,1607
"2617",2617,0,4,4,4,"4059",735,38,697
"2618",2618,0,0,0,0,"4060",4651,226,4425
"2619",2619,3014,215,4667,3272,"4061",4175,222,3953
"2620",2620,194,50,518,247,"4062",3543,168,3375
"2621",2621,2332,242,4204,2621,"4063",4261,742,3519
"2622",2622,2180,216,3793,2424,"4065",2283,172,2111
"2623",2623,3149,242,5080,3445,"4066",2895,93,2802
"2624",2624,661,46,1044,720,"4067",3402,366,3036
"2625",2625,1512,244,2560,1777,"4068",2902,380,2522
"2626",2626,1943,822,4201,2809,"4069",4557,591,3966
"2627",2627,186,40,386,230,"4070",2537,180,2357
"2628",2628,1927,320,3400,2284,"4071",1172,50,1122
"2629",2629,630,883,2585,1544,"4072",545,42,503
"2630",2630,1631,1320,5059,2991,"4073",2502,659,1843
"2631",2631,39,9,83,50,"4074",3260,1276,1984
"2632",2632,897,381,2478,1320,"4075",1969,300,1669
"2633",2633,987,281,2515,1293,"4076",6509,566,5943
"2634",2634,1620,275,2856,1924,"4077",1257,457,800
"2635",2635,85,14,148,100,"4078",2712,1027,1685
"2636",2636,1214,1304,3438,2576,"4079",4791,2716,2075
"2637",2637,977,917,2635,1936,"4080",694,498,196
"2638",2638,1619,1804,4720,3476,"4081",5302,151,5151
"2639",2639,889,970,2525,1895,"4082",2592,863,1729
"2640",2640,788,749,2247,1573,"4083",2095,613,1482
"2641",2641,1238,1180,3349,2471,"4084",1090,17,1073
"2642",2642,1335,1233,3721,2627,"4085",1438,55,1383
"2643",2643,479,514,1460,1005,"4086",4848,535,4313
"2644",2644,1302,1375,3772,2729,"4087",4564,241,4323
"2645",2645,818,1416,2923,2272,"4088",2433,87,2346
"2646",2646,1070,1525,3430,2650,"4090",220,32,188
"2647",2647,985,1011,2965,2041,"4091A",14,4,10
"2648",2648,1131,1470,3673,2651,"4091B",0,0,0
"2649",2649,426,789,1677,1246,"4091C",0,0,0
"2650",2650,1049,1457,3373,2560,"4092",229,72,157
"2651",2651,632,876,2027,1541,"4093",174,24,150
"2652",2652,447,570,1443,1039,"4094",724,156,568
"2653",2653,188,77,580,268,"4095",77,22,55
"2654",2654,582,158,1267,756,"4096",154,149,5
"2655",2655,502,278,1064,798,"4097A",1652,343,1309
"2656",2656,154,36,464,192,"4097B",0,0,0
"2657",2657,814,283,1790,1125,"4098",37,26,11
"2658",2658,417,180,1011,612,"4099",1360,962,398
"2659",2659,628,307,1302,953,"4100",21,16,5
"2660",2660,113,61,208,175,"4101",196,1,195
"2661",2661,248,55,806,313,"4102",292,246,46
"2662",2662,700,175,1601,899,"4103",182,98,84
"2663",2663,674,378,1387,1080,"4104",41,31,10
"2664",2664,393,110,875,517,"4105",17,9,8
"2665",2665,37,26,89,64,"4106",322,232,90
"2666",2666,138,124,324,266,"4107",236,3,233
"2667",2667,800,760,1954,1604,"4108",88,0,88
"2668",2668,884,249,1699,1163,"4109",95,1,94
"2669",2669,936,215,1729,1176,"4110",1499,11,1488
"2670",2670,254,117,476,381,"4111",562,27,535
"2671",2671,546,306,1143,865,"4112",1860,1259,601
"2672",2672,1467,286,2795,1792,"4113",3330,153,3177
"2673",2673,522,163,1157,697,"4114",2785,167,2618
"2674",2674,1440,292,2595,1768,"4115",340,238,102
"2675",2675,768,173,1694,968,"4116",0,0,0
"2676",2676,1,1,7,2,"4117",227,82,145
"2677",2677,1025,151,2370,1210,"4118",0,0,0
"2678",2678,196,13,394,216,"4119",0,0,0
"2679",2679,73,13,157,87,"4120",3766,88,3678
"2680",2680,143,37,381,185,"4121",0,0,0
"2681",2681,509,38,1063,554,"4122",0,0,0
"2682",2682,5,2,22,7,"4123",0,0,0
"2683",2683,13,2,26,15,"4124",0,0,0
"2684",2684,1099,96,2397,1223,"4125",0,0,0
"2685",2685,1086,391,2189,1508,"4300",2727,178,2549
"2686",2686,692,104,1276,805,"4500",3005,777,2228
"2687",2687,435,61,928,504,"4501",2888,957,1931
"2688",2688,96,21,187,120,"4502",4441,1062,3379
"2689",2689,1042,114,2071,1180,"4503",5726,1035,4691
"2690",2690,282,28,688,317,"4504",1826,431,1395
"2691",2691,365,28,829,409,"4505",2836,878,1958
"2692",2692,293,27,641,327,"4506",2579,593,1986
"2693",2693,616,82,1316,715,"4507",1676,176,1500
"2694",2694,519,62,1214,594,"4508",1541,293,1248
"2695",2695,592,65,1362,678,"4509",2530,710,1820
"2696",2696,412,29,947,452,"4510",3695,498,3197
"2697",2697,1,6,106,8,"4511",3684,834,2850
"2698",2698,0,0,0,0,"4512",2796,782,2014
"2699",2699,2298,661,4250,3035,"4513",5585,1025,4560
"2700",2700,1,0,0,1,"4514",2553,686,1867
"2701",2701,1949,590,4166,2593,"4515",4559,574,3985
"2702",2702,220,64,467,290,"4516",563,149,414
"2703",2703,241,62,555,306,"4517",4193,2028,2165
"2704",2704,1176,332,2775,1540,"4518",4646,960,3686
"2705",2705,1345,219,2935,1593,"4519",3401,1051,2350
"2706",2706,776,190,1678,989,"4520",1599,279,1320
"2707",2707,443,134,1051,586,"4521",5359,1622,3737
"2708",2708,186,45,407,237,"4522",4131,1030,3101
"2709",2709,1053,236,2703,1318,"4523",521,171,350
"2710",2710,1033,282,2553,1346,"4525",2628,409,2219
"2711",2711,827,208,2026,1063,"4527",3440,563,2877
"2712",2712,1478,358,3012,1872,"4528",0,0,0
"2713",2713,310,91,844,410,"4529",768,219,549
"2714",2714,461,145,1304,620,"4530",1258,79,1179
"2715",2715,901,237,2142,1171,"4531",899,282,617
"2716",2716,890,230,2049,1145,"4532",457,99,358
"2717",2717,1457,322,3098,1827,"4533",1562,234,1328
"2718",2718,701,164,1745,889,"4534",123,25,98
"2719",2719,158,37,383,198,"4535",1396,146,1250
"2720",2720,139,27,340,170,"4536",92,22,70
"2721",2721,798,220,1523,1037,"4537",21,3,18
"2722",2722,1537,357,2784,1936,"4538",1659,276,1383
"2723",2723,522,113,1195,653,"4539",0,0,0
"2724",2724,1310,355,3115,1699,"4540",0,0,0
"2725",2725,619,108,1031,753,"4541",0,0,0
"2726",2726,1084,228,1911,1346,"4542",0,0,0
"2727",2727,2246,697,3878,3013,"4600",3318,902,2416
"2728",2728,377,197,678,589,"4601",5413,1901,3512
"2729",2729,1418,279,3776,1729,"4602",3093,867,2226
"2730",2730,942,188,1553,1152,"4603",151,22,129
"2731",2731,746,178,1406,941,"4604",4997,1208,3789
"2732",2732,281,50,655,338,"4605",4079,1145,2934
"2733",2733,398,102,1052,512,"4606",5461,1283,4178
"2734",2734,1361,310,3016,1709,"4607",4129,706,3423
"2735",2735,379,82,1146,470,"4608A",6583,1590,4993
"2736",2736,177,39,502,219,"4608B",5,0,5
"2737",2737,36,17,99,54,"4609",4579,508,4071
"2738",2738,0,0,0,0,"4610",3803,1268,2535
"2739",2739,85,29,173,120,"4611",3653,935,2718
"2740",2740,54,1,105,56,"4612",443,192,251
"2741",2741,239,95,497,340,"4613",1743,204,1539
"2742",2742,20,12,45,32,"4614",534,347,187
"2743",2743,2,7,20,10,"4615",359,87,272
"2744",2744,451,182,996,652,"4616",3373,449,2924
"2745",2745,25,12,42,38,"4617",254,95,159
"2746",2746,537,466,1261,1032,"4618",826,183,643
"2747",2747,0,0,0,0,"4619",1722,756,966
"2748",2748,0,0,0,0,"4620",3645,824,2821
"2749",2749,15,2,22,17,"4621",6523,1155,5368
"2750",2750,55,6,147,61,"4622",2970,787,2183
"2751",2751,65,9,139,75,"4623",4340,1029,3311
"2752",2752,27,2,67,29,"4624",3192,961,2231
"2753",2753,32,3,60,35,"4625",3457,1286,2171
"2754",2754,477,25,1030,516,"4626",3647,1559,2088
"2755",2755,145,48,351,196,"4627A",9062,3764,5298
"2756",2756,25,57,148,91,"4627B",0,0,0
"2757",2757,875,279,2188,1192,"4628",4306,683,3623
"2758",2758,730,199,1855,949,"4629",2853,523,2330
"2759",2759,205,63,326,273,"4630",2128,921,1207
"2760",2760,0,0,0,0,"4631",1786,833,953
"2761",2761,17,12,166,29,"4632",3840,608,3232
"2762",2762,0,0,1,0,"4633",3900,447,3453
"2763",2763,2,2,5,4,"4634",6528,2489,4039
"2764",2764,261,41,791,309,"4635",4428,676,3752
"2765",2765,0,0,0,0,"4636",9,7,2
"2766",2766,0,0,0,0,"4637",7099,1871,5228
"2767",2767,625,681,1577,1339,"4639",1782,288,1494
"2768",2768,169,250,509,430,"4640",5295,982,4313
"2769",2769,512,596,1358,1135,"4641",850,271,579
"2770",2770,597,870,1750,1505,"4642",345,76,269
"2771",2771,749,681,1757,1458,"4644",1574,139,1435
"2772",2772,1043,213,1882,1281,"4645",320,25,295
"2773",2773,792,175,1743,991,"4646",1230,334,896
"2774",2774,81,25,137,107,"4647",4767,1658,3109
"2775",2775,77,8,168,87,"4648",5071,757,4314
"2776",2776,0,0,0,0,"4649",465,23,442
"2777",2777,21,5,36,27,"4651",251,14,237
"2778",2778,35,9,65,45,"4652",2559,241,2318
"2779",2779,0,0,1,0,"4653",638,49,589
"2780",2780,150,46,261,202,"4654",3156,427,2729
"2781",2781,124,35,336,162,"4655",68,40,28
"2782",2782,434,134,919,575,"4656",205,33,172
"2783",2783,0,0,0,0,"4657",263,11,252
"2784",2784,0,0,0,0,"4658",140,38,102
"2785",2785,581,224,1599,834,"4659",528,90,438
"2786",2786,1051,597,2385,1670,"4660",70,24,46
"2787",2787,953,613,2383,1597,"4661",2456,197,2259
"2788",2788,1646,847,3686,2544,"4662",537,105,432
"2789",2789,2200,888,4624,3137,"4663",0,0,0
"2790",2790,572,354,1470,943,"4664",4702,1335,3367
"2791",2791,810,533,2148,1373,"0001",3186,901,2285
"2792",2792,493,352,1535,872,"0002",1786,492,1294
"2793",2793,542,79,1243,638,"0003",1852,1001,851
"2794",2794,208,136,714,356,"0004",1851,867,984
"2795",2795,457,499,1686,973,"0005",179,106,73
"2796",2796,776,421,2282,1230,"0011",217,133,84
"2797",2797,627,397,2001,1045,"0012",92,51,41
"2798",2798,406,387,1452,812,"0013",168,137,31
"2799",2799,987,451,2994,1466,"0017",119,66,53
"2800",2800,462,405,1451,885,"0001",2799,553,2246
"2801",2801,763,328,2320,1118,"0002",3185,607,2578
"2802",2802,15,3,47,18,"0003",3839,1634,2205
"2803",2803,1040,1186,3221,2281,"0004",3126,678,2448
"2804",2804,718,477,2117,1210,"0001",764,694,70
"2805",2805,1447,942,3190,2425,"0003",648,464,184
"2806",2806,381,205,1058,598,"0004",685,538,147
"2807",2807,1730,1197,4320,2983,"0005",986,767,219
"2808",2808,1678,899,3850,2634,"0007",271,243,28
"2809",2809,300,146,557,453,"0009",289,265,24
"2810",2810,555,258,1494,837,"0010",438,390,48
"2811",2811,575,316,1830,919,"1000",3494,2721,773
"2812",2812,0,0,0,0,"1001",2093,1621,472
"2813",2813,327,205,759,543,"1002",2047,1575,472
"2814",2814,124,25,364,155,"1003",4464,2972,1492
"2815",2815,155,189,607,351,"1004",4965,2891,2074
"2816",2816,107,84,331,196,"1005",2787,2247,540
"2817",2817,435,243,1074,691,"1006",6893,4226,2667
"2818",2818,38,10,97,49,"1007",5881,3487,2394
"2819",2819,330,168,926,506,"1008",1471,1174,297
"2820",2820,18,10,47,29,"1009",5101,2658,2443
"2821",2821,3,0,3,3,"1010",3558,2313,1245
"2822",2822,353,161,969,529,"1011",4090,2458,1632
"2823",2823,0,0,0,0,"1012",2805,2235,570
"2824",2824,0,0,0,0,"1013",5450,2521,2929
"2825",2825,0,0,0,0,"1014",627,349,278
"2826",2826,16,16,60,33,"1015",3055,2250,805
"2827",2827,10,9,34,19,"1016",3775,2539,1236
"2828",2828,0,0,0,0,"1017",1405,977,428
"2829",2829,0,0,0,0,"1018",6391,4216,2175
"2830",2830,0,0,0,0,"1019",3815,1996,1819
"2831",2831,883,770,2489,1683,"1020",4339,3255,1084
"2832",2832,1326,1273,3980,2653,"1021",3529,2528,1001
"2833",2833,720,567,2077,1308,"1022",4300,2731,1569
"2834",2834,21,8,81,29,"1023",4966,3360,1606
"2835",2835,1047,782,3064,1856,"1024",2187,1789,398
"2836",2836,864,688,2589,1582,"1025",6070,3816,2254
"2837",2837,1010,726,2989,1779,"1026",4065,1914,2151
"2838",2838,667,419,1957,1109,"1027",2501,1079,1422
"2839",2839,1578,668,3735,2301,"1028",3808,1418,2390
"2840",2840,834,252,2123,1113,"1029",3845,2110,1735
"2841",2841,761,745,2395,1550,"1030",4911,3302,1609
"2842",2842,592,443,1783,1052,"1031",3434,2210,1224
"2843",2843,114,108,340,229,"1032",6117,3219,2898
"2844",2844,319,113,839,442,"1033",6062,2695,3367
"2845",2845,150,218,521,388,"1034",6043,3044,2999
"2846",2846,76,57,226,133,"1035",3456,2318,1138
"2847",2847,483,287,1370,784,"1036",4831,4348,483
"2848",2848,67,55,185,123,"1037",1149,887,262
"2849",2849,176,125,482,304,"1038",540,309,231
"2850",2850,445,504,1301,967,"1039",189,105,84
"2851",2851,588,477,1705,1095,"1040",2814,2007,807
"2852",2852,1741,501,3815,2298,"1041",6699,3469,3230
"2853",2853,760,514,2021,1302,"1042",330,230,100
"2854",2854,988,580,2589,1601,"1043",1485,741,744
"2855",2855,621,476,1693,1131,"1044",7449,4158,3291
"2856",2856,820,711,2210,1570,"1045",1641,1413,228
"2857",2857,1012,993,2786,2037,"1046",4840,3201,1639
"2858",2858,1833,1128,4328,3034,"1047",1597,493,1104
"2859",2859,972,239,2244,1244,"1048",1021,724,297
"2860",2860,571,273,1448,859,"1049",1085,451,634
"2861",2861,558,532,1591,1108,"1050",2900,1630,1270
"2862",2862,464,406,1252,898,"1051",2204,1483,721
"2863",2863,893,374,1973,1288,"1052",4827,2648,2179
"2864",2864,444,170,1049,627,"1053",4050,2864,1186
"2865",2865,1510,1141,3879,2706,"1054",4484,1876,2608
"2866",2866,254,128,710,388,"1055",1972,839,1133
"2867",2867,1264,455,2860,1761,"1056",2115,1115,1000
"2868",2868,215,146,569,369,"1057",1550,617,933
"2869",2869,50,44,187,96,"2000",7034,1959,5075
"2870",2870,7,2,14,11,"2001",7352,2251,5101
"2871",2871,174,161,604,343,"2002",8588,2575,6013
"2872",2872,1072,346,2397,1447,"2003",2907,1058,1849
"2873",2873,37,11,122,49,"2004",4923,1828,3095
"2874",2874,18,6,75,25,"2005",4602,2493,2109
"2875",2875,289,125,865,425,"2006",4219,1959,2260
"2876",2876,32,13,128,49,"2007",6259,1535,4724
"2877",2877,417,259,1254,690,"2008",4749,1852,2897
"2878",2878,6,41,52,48,"2009",3070,1665,1405
"2879",2879,59,25,149,85,"2010",5608,2730,2878
"2880",2880,33,13,109,47,"2011",4883,1898,2985
"2881",2881,27,29,93,57,"2012",2057,1435,622
"2882",2882,91,51,239,144,"2013",1947,1271,676
"2883",2883,14,9,46,23,"2014",2940,1739,1201
"2884",2884,380,140,993,524,"2015A",4954,2516,2438
"2885",2885,118,64,336,189,"2015B",0,0,0
"2886",2886,0,0,0,0,"2016",5275,2576,2699
"2887",2887,465,287,1096,767,"2017",5043,3036,2007
"2888",2888,0,0,0,0,"2018",7692,4080,3612
"2889",2889,0,0,0,0,"2019",0,0,0
"2890",2890,0,0,0,0,"2020",4736,3416,1320
"2891",2891,0,0,0,0,"2021",5827,2946,2881
"2892",2892,43,20,135,66,"2022",3274,2030,1244
"2893",2893,278,147,520,431,"2023",4998,2454,2544
"2894",2894,63,33,117,97,"2024",2838,1501,1337
"2895",2895,219,409,1496,639,"2025",2762,1590,1172
"2896",2896,205,427,1528,645,"2026",4175,2700,1475
"2897",2897,200,902,1733,1112,"2027",5558,3469,2089
"2898",2898,137,814,1653,961,"2028",6193,2628,3565
"2899",2899,12,88,174,101,"2029",3985,1743,2242
"2900",2900,8,96,186,105,"2030",6602,3075,3527
"2901",2901,9,49,71,61,"2031",5024,2178,2846
"2902",2902,9,88,127,97,"2032",3038,1602,1436
"2903",2903,4,59,121,64,"2033",5024,1883,3141
"2904",2904,277,658,2050,943,"2034",4564,1366,3198
"2905",2905,324,550,2028,888,"2035",4812,2090,2722
"2906",2906,333,1404,2769,1754,"2036",834,339,495
"2907",2907,329,681,2044,1023,"2096",0,0,0
"2908",2908,72,501,813,581,"2097",0,0,0
"2909",2909,69,192,517,266,"2098",0,0,0
"2910",2910,61,350,691,420,"2099",0,0,0
"2911",2911,99,507,940,611,"3000",5975,3661,2314
"2912",2912,20,157,264,179,"3001",3823,2797,1026
"2913",2913,21,199,271,221,"3002",4161,3368,793
"2914",2914,61,256,442,322,"3003",2788,2098,690
"2915",2915,429,1842,3105,2305,"3004",3131,2606,525
"2916",2916,227,894,1553,1132,"3005",1948,1657,291
"2917",2917,33,127,220,161,"3006",4425,2640,1785
"2918",2918,301,1102,1928,1421,"3007",5435,2734,2701
"2919",2919,562,1586,3169,2197,"3008",3208,2177,1031
"2920",2920,0,2,4,2,"3009",3871,2246,1625
"2921",2921,2,0,5,2,"3010",7652,2818,4834
"2922",2922,270,754,1371,1038,"3011",9203,2554,6649
"2923",2923,562,1976,3646,2570,"3012",2115,1210,905
"2924",2924,24,128,223,156,"3013",3662,1761,1901
"2925",2925,591,2086,3623,2717,"3014",2415,1259,1156
"2926",2926,243,1028,1634,1294,"3015",3388,1430,1958
"2927",2927,253,318,792,583,"3016",3731,1466,2265
"2928",2928,801,1004,2505,1844,"3017",8140,2492,5648
"2929",2929,1003,950,2447,1980,"3018",3239,808,2431
"2930",2930,406,455,1075,884,"3019",7961,2932,5029
"2931",2931,1188,1468,3309,2690,"3020",2125,432,1693
"2932",2932,975,1206,2721,2210,"3021",8364,3502,4862
"2933",2933,268,224,553,495,"3022",247,144,103
"2934",2934,979,1234,2711,2234,"3023",549,224,325
"2935",2935,762,1007,2265,1788,"3024",3852,2295,1557
"2936",2936,1101,1387,3306,2527,"3025",4889,3446,1443
"2937",2937,1495,1474,3581,2989,"3026",2721,1785,936
"2938",2938,820,908,2243,1749,"3027",4473,3254,1219
"2939",2939,1257,1521,3485,2805,"3028",4419,3160,1259
"2940",2940,698,837,1929,1554,"3029",3072,2109,963
"2941",2941,1528,2841,4974,4394,"3030",2716,2011,705
"2942",2942,305,240,802,551,"3031",3420,2180,1240
"2943",2943,103,82,276,189,"3032",4277,1659,2618
"2944",2944,32,26,84,58,"3033",3360,2377,983
"2945",2945,7,5,17,12,"3098",0,0,0
"2946",2946,1008,859,2676,1897,"3099",0,0,0
"2947",2947,1565,2102,4714,3707,"4000",5528,4096,1432
"2948",2948,924,1371,2982,2331,"4001",1994,1408,586
"2949",2949,366,311,966,689,"4002",4790,3742,1048
"2950",2950,1800,1528,4822,3382,"4003",4288,3982,306
"2951",2951,1375,1456,3723,2871,"4004",4421,2010,2411
"2952",2952,656,577,1616,1245,"4005",2944,2044,900
"2953",2953,531,415,1249,962,"4006",3024,2023,1001
"2954",2954,341,274,773,624,"4007",3497,2237,1260
"2955",2955,433,336,1008,780,"4008",2090,1492,598
"2956",2956,1595,1462,4030,3108,"4009",7373,3040,4333
"2957",2957,980,985,2683,1994,"4010",2931,1596,1335
"2958",2958,800,650,1755,1463,"4011",9406,4195,5211
"2959",2959,444,689,1455,1150,"4012",3223,1905,1318
"2960",2960,996,1546,3262,2582,"4013",603,367,236
"2961",2961,201,429,867,637,"4014",3045,1240,1805
"2962",2962,1544,1185,3657,2772,"4015",1507,810,697
"2963",2963,1400,840,3254,2274,"4016",11,3,8
"2964",2964,1423,1487,4004,2960,"4017",4196,3679,517
"2965",2965,171,184,492,361,"4018",2347,1780,567
"2966",2966,231,221,565,459,"4019",423,354,69
"2967",2967,1065,1016,2598,2103,"4020",899,778,121
"2968",2968,163,253,535,424,"4021",1759,1430,329
"2969",2969,837,1058,2622,1931,"4022",2385,2030,355
"2970",2970,319,405,987,734,"4023A",3319,2531,788
"2971",2971,405,469,1179,894,"4023B",265,117,148
"2972",2972,278,243,794,533,"4024",3233,2557,676
"2973",2973,931,804,2643,1771,"4025",3718,2390,1328
"2974",2974,1127,907,2773,2086,"4026",1730,1117,613
"2975",2975,543,415,1342,986,"4027",4132,2602,1530
"2976",2976,1331,852,3286,2241,"4028",4412,3481,931
"2977",2977,1147,649,2518,1825,"4029",1595,1018,577
"2978",2978,628,702,1786,1363,"4030",540,400,140
"2979",2979,1196,966,2843,2209,"4031",4107,3521,586
"2980",2980,349,383,1211,751,"4032",5213,3933,1280
"2981",2981,66,71,226,140,"4033",4449,2985,1464
"2982",2982,568,635,1989,1227,"4034",6188,3973,2215
"2983",2983,1291,1600,3936,2940,"4035",7859,5683,2176
"2984",2984,952,1032,2686,2022,"4036",3771,3030,741
"2985",2985,61,71,142,132,"4037",2475,1365,1110
"2986",2986,1230,2190,4424,3477,"4038",377,247,130
"2987",2987,1077,1683,3833,2826,"4039",3755,1939,1816
"2988",2988,1120,1917,4192,3101,"4040",1646,1255,391
"2989",2989,479,1274,2295,1775,"4041",3307,1427,1880
"2990",2990,195,306,782,506,"4042",65,46,19
"2991",2991,1077,913,3035,2050,"4043",3307,2542,765
"2992",2992,1352,1125,3429,2521,"4044",4056,3179,877
"2993",2993,741,657,1821,1424,"4045",6628,2805,3823
"2994",2994,1068,1528,3321,2631,"4046",3445,2657,788
"2995",2995,1046,1156,2854,2225,"4047",2588,1731,857
"2996",2996,1634,1384,3726,3055,"4048",5863,4005,1858
"2997",2997,530,438,1202,979,"4049",3016,2104,912
"2998",2998,701,737,1808,1450,"0101",2986,1425,1561
"2999",2999,1176,1469,3689,2702,"0102",1598,335,1263
"3000",3000,1197,1592,3947,2851,"0201",555,361,194
"3001",3001,956,1333,3248,2337,"0202",1728,1008,720
"3002",3002,1446,1463,4225,2955,"0203",1205,771,434
"3003",3003,770,819,2412,1630,"0301",1575,1035,540
"3004",3004,982,1498,3199,2499,"0302",1411,858,553
"3005",3005,1589,1467,4547,3112,"0303",551,386,165
"3006",3006,1422,2127,4474,3578,"0401",2730,1855,875
"3007",3007,1767,1139,4093,2953,"0402",1079,935,144
"3008",3008,171,107,388,280,"0001",124,92,32
"3009",3009,1461,875,3032,2359,"0002",96,76,20
"3010",3010,994,1183,2686,2211,"0003A",83,68,15
"3011",3011,1258,1613,3552,2903,"0003B",74,49,25
"3012",3012,1749,1544,4273,3341,"0003C",210,110,100
"3013",3013,225,142,517,372,"0004A",307,195,112
"3014",3014,1020,1285,2942,2339,"0004B",8,4,4
"3015",3015,1770,648,4277,2471,"0005",206,156,50
"3016",3016,1954,568,4186,2567,"0006",261,219,42
"3017",3017,2183,1042,5382,3285,"0001",1664,214,1450
"3018",3018,904,627,2307,1555,"0002",1718,178,1540
"3019",3019,1377,1127,3737,2545,"0003",395,40,355
"3020",3020,857,924,2325,1802,"0004",87,13,74
"3021",3021,1593,1293,4001,2946,"0005",676,35,641
"3022",3022,1480,1524,3891,3045,"0006",1016,122,894
"3023",3023,770,698,2071,1490,"0007",752,144,608
"3024",3024,1626,1001,3747,2674,"0101",346,263,83
"3025",3025,966,902,2642,1901,"0102",357,312,45
"3026",3026,1800,1298,4414,3155,"0201",668,568,100
"3027",3027,698,605,1734,1315,"0301",254,205,49
"3028",3028,1336,1341,3597,2719,"0303",315,255,60
"3029",3029,769,666,1911,1452,"0401",651,486,165
"3030",3030,1424,846,3104,2303,"0001",1724,93,1631
"3031",3031,2367,1395,5202,3812,"0002",1089,45,1044
"3032",3032,423,200,987,634,"0003",386,23,363
"3033",3033,855,785,2510,1657,"0004",122,31,91
"3034",3034,61,57,182,120,"0005",441,70,371
"3035",3035,701,649,2065,1367,"0006",147,12,135
"3036",3036,810,640,2336,1473,"0007",200,42,158
"3037",3037,1020,430,2462,1473,"0008",1817,272,1545
"3038",3038,2217,1289,5180,3546,"0009",1586,231,1355
"3039",3039,73,105,226,180,"0001",3352,2572,780
"3040",3040,194,180,476,380,"0002",426,363,63
"3041",3041,944,500,2427,1473,"0003",2140,1605,535
"3042",3042,1744,683,4454,2476,"0004",337,279,58
"3043",3043,1025,702,2589,1757,"0005",879,562,317
"3044",3044,861,754,2196,1645,"0006",397,327,70
"3045",3045,1757,1298,5248,3104,"0007",2314,2022,292
"3046",3046,1409,1518,4342,2978,"0008",3558,2891,667
"3047",3047,1197,990,3114,2226,"0009",583,535,48
"3048",3048,1731,2011,5127,3831,"0101",9192,2740,6452
"3049",3049,666,865,2116,1564,"0102",7333,1449,5884
"3050",3050,1697,1548,5036,3303,"0103",3631,1143,2488
"3051",3051,660,720,1834,1400,"0104",593,180,413
"3052",3052,994,931,2778,1963,"0106",1949,878,1071
"3053",3053,1315,1602,3647,2952,"0107",1775,1025,750
"3054",3054,1433,1948,4430,3440,"0108",4330,2091,2239
"3055",3055,1517,1851,4288,3413,"0109",294,202,92
"3056",3056,974,2159,3961,3179,"0110",7048,2692,4356
"3057",3057,163,361,665,533,"0111",1128,344,784
"3058",3058,598,741,1757,1365,"0201",8607,4905,3702
"3059",3059,1315,1551,3626,2905,"0202",3242,1852,1390
"3060",3060,1553,1946,4594,3556,"0203",3961,2147,1814
"3061",3061,894,1170,2666,2096,"0204",1775,912,863
"3062",3062,1437,1933,4505,3441,"0205",2547,1308,1239
"3063",3063,839,1105,2827,1986,"0206",1093,616,477
"3064",3064,925,1198,2821,2154,"0207",2236,1552,684
"3065",3065,809,1203,2790,2051,"0208",5941,2635,3306
"3066",3066,1064,1679,3489,2776,"0209",1952,869,1083
"3067",3067,587,1104,2190,1726,"0301",3345,941,2404
"3068",3068,836,1612,3082,2494,"0302",1498,502,996
"3069",3069,906,1549,3121,2491,"0303",3296,844,2452
"3070",3070,1312,2108,4292,3463,"0304",1271,201,1070
"3071",3071,191,526,895,721,"0305",1161,192,969
"3072",3072,74,210,357,285,"0306",2758,534,2224
"3073",3073,945,1929,3721,2924,"0307",3926,1083,2843
"3074",3074,1166,1859,4618,3080,"0308",1271,511,760
"3075",3075,960,1706,3461,2701,"0309",1728,748,980
"3076",3076,1026,1040,3058,2106,"0311",1622,510,1112
"3077",3077,169,198,505,375,"0312",1871,882,989
"3078",3078,34,40,102,75,"0401",1406,473,933
"3079",3079,1119,912,2856,2080,"0402",4032,591,3441
"3080",3080,1568,1818,4666,3467,"0403",4346,196,4150
"3081",3081,2610,1061,6146,3755,"0404",3005,623,2382
"3082",3082,863,540,2213,1458,"0405",1824,118,1706
"3083",3083,1718,688,4231,2462,"0406",4922,786,4136
"3084",3084,899,305,1847,1243,"0407",2416,682,1734
"3085",3085,1331,511,2748,1897,"0408",1314,218,1096
"3086",3086,2251,395,4753,2727,"0409",2230,350,1880
"3087",3087,184,65,406,255,"0412",1591,428,1163
"3088",3088,1109,178,2211,1328,"0001",276,78,198
"3089",3089,7,1,14,8,"0002",312,214,98
"3090",3090,1005,162,2023,1199,"0003",302,188,114
"3091",3091,160,51,380,220,"0004",250,90,160
"3092",3092,975,1115,2796,2138,"0101",4598,2868,1730
"3093",3093,368,158,898,536,"0102",5639,3804,1835
"3094",3094,828,457,2029,1315,"0103",5380,3850,1530
"3095",3095,1142,1521,3446,2706,"0104",3873,2932,941
"3096",3096,435,606,1303,1056,"0105",5898,4056,1842
"3097",3097,1541,1799,4518,3399,"0106",3268,2649,619
"3098",3098,28,67,125,96,"0107",3715,2828,887
"3099",3099,89,324,519,418,"0108",3474,2519,955
"3100",3100,915,2183,3970,3160,"0109",1862,1363,499
"3101",3101,426,1115,1739,1551,"0110",5508,2236,3272
"3102",3102,699,1837,2865,2557,"0111",2886,1932,954
"3103",3103,914,248,2094,1198,"0112",2518,1490,1028
"3104",3104,0,1,2,1,"0113",2443,550,1893
"3105",3105,134,327,643,466,"0114",3247,1922,1325
"3106",3106,572,1568,2948,2184,"0115",2164,1213,951
"3107",3107,375,1065,1984,1467,"0116",2499,1603,896
"3108",3108,271,774,1442,1069,"0117",3668,2290,1378
"3109",3109,631,2420,4131,3092,"0118",3726,2425,1301
"3110",3110,77,321,531,405,"0119",1910,1191,719
"3111",3111,120,277,493,401,"0120",1087,513,574
"3112",3112,901,1984,3551,2913,"0121",2825,1742,1083
"3113",3113,244,891,1426,1147,"0122",1747,1165,582
"3114",3114,525,1896,3035,2445,"0123",1575,127,1448
"3115",3115,14,31,57,46,"0124",2796,687,2109
"3116",3116,15,33,61,49,"0125",5768,3279,2489
"3117",3117,524,1137,2114,1691,"0126",1425,744,681
"3118",3118,1004,1989,3699,3034,"0127",788,406,382
"3119",3119,820,1820,3267,2672,"0128",403,146,257
"3120",3120,944,1559,3287,2544,"0129",1100,583,517
"3121",3121,959,1845,3536,2836,"0130",840,479,361
"3122",3122,79,150,289,231,"0131",2290,1496,794
"3123",3123,579,1496,2629,2101,"0132",761,486,275
"3124",3124,270,862,1435,1144,"0133",774,436,338
"3125",3125,337,790,1321,1144,"0134",964,644,320
"3126",3126,655,1250,2611,1939,"0135",4468,3426,1042
"3127",3127,1389,2887,5420,4346,"0136",559,475,84
"3128",3128,1057,2467,4363,3579,"0137",1370,1105,265
"3129",3129,133,265,535,403,"0138",2516,1561,955
"3130",3130,323,575,1250,923,"0139",1042,766,276
"3131",3131,491,953,1963,1468,"0140",7123,4300,2823
"3132",3132,755,1357,2673,2155,"0141",2172,1505,667
"3133",3133,308,682,1226,1003,"0142",2905,1621,1284
"3134",3134,387,853,1537,1260,"0143",3269,2086,1183
"3135",3135,102,236,424,343,"0144",2491,841,1650
"3136",3136,489,1913,3165,2433,"0145",5379,2187,3192
"3137",3137,317,1278,2353,1622,"0146",3335,1800,1535
"3138",3138,51,86,201,141,"0147",4628,2783,1845
"3139",3139,897,1541,3537,2489,"0148",4098,1513,2585
"3140",3140,690,1242,2443,1971,"0149",2210,896,1314
"3141",3141,418,740,1673,1171,"0001",2704,244,2460
"3142",3142,0,0,0,0,"0002",6520,810,5710
"3143",3143,0,0,0,0,"0003",4228,453,3775
"3144",3144,0,0,2,0,"0004",2385,287,2098
"3145",3145,0,0,0,0,"0005",4683,497,4186
"3146",3146,0,0,0,0,"0006",2360,850,1510
"3147",3147,0,0,0,0,"0007",3244,913,2331
"3148",3148,0,0,0,0,"0008",2563,1196,1367
"3149",3149,0,0,0,0,"0009",3541,1031,2510
"3150",3150,0,0,0,0,"0010",5920,518,5402
"3151",3151,0,0,0,0,"0011",4443,700,3743
"3152",3152,0,0,0,0,"0012",1878,546,1332
"3153",3153,0,0,0,0,"0013",3629,726,2903
"3154",3154,0,0,0,0,"0014",4269,1179,3090
"3155",3155,213,996,1670,1220,"0015",2705,931,1774
"3156",3156,321,259,1319,592,"0016",4137,591,3546
"3157",3157,51,322,534,375,"0017",2037,506,1531
"3158",3158,142,620,1203,764,"0018",3334,1254,2080
"3159",3159,91,616,1033,709,"0019",5391,1187,4204
"3160",3160,127,877,1493,1010,"0020",1377,374,1003
"3161",3161,136,674,1263,814,"0021",2260,822,1438
"3162",3162,51,251,434,304,"0022",3680,900,2780
"3163",3163,284,1145,2038,1441,"0023",1564,585,979
"3164",3164,78,807,1071,889,"0024",3801,1244,2557
"3165",3165,8,56,77,64,"0025",4563,1043,3520
"3166",3166,11,99,140,114,"0026",1991,518,1473
"3167",3167,39,195,324,239,"0027",2714,518,2196
"3168",3168,28,141,282,173,"0028",493,9,484
"3169",3169,16,152,200,168,"0029",3885,600,3285
"3170",3170,28,210,304,243,"0030",280,5,275
"3171",3171,505,384,1715,903,"0031",3711,695,3016
"3172",3172,527,283,1776,828,"0032",2322,461,1861
"3173",3173,147,117,547,273,"0033",1899,622,1277
"3174",3174,33,32,83,65,"0034",2115,245,1870
"3175",3175,448,167,1086,622,"0035",2629,736,1893
"3176",3176,359,237,1287,610,"0036",3384,397,2987
"3177",3177,245,164,835,421,"0037",5227,412,4815
"3178",3178,43,344,523,392,"0038",3508,286,3222
"3179",3179,61,355,634,419,"0039",1521,169,1352
"3180",3180,18,164,284,182,"0040",1346,147,1199
"3181",3181,25,232,303,258,"0041",1381,79,1302
"3182",3182,51,343,568,397,"0042",3528,100,3428
"3183",3183,730,548,2163,1337,"0043",2289,745,1544
"3184",3184,553,336,1326,921,"0044",4562,1213,3349
"3185",3185,184,85,518,275,"0045",4620,948,3672
"3186",3186,42,54,188,97,"0046",1889,358,1531
"3187",3187,131,130,406,271,"0047",2816,769,2047
"3188",3188,66,30,165,98,"0048",2575,370,2205
"3189",3189,22,69,107,95,"0049",2511,584,1927
"3190",3190,456,879,2174,1373,"0050",3899,558,3341
"3191",3191,391,312,1282,738,"0051",3042,827,2215
"3192",3192,240,1649,2835,1910,"0052",3042,470,2572
"3193",3193,29,230,375,264,"0053",3995,662,3333
"3194",3194,166,870,1987,1049,"0054",3991,549,3442
"3195",3195,20,223,317,246,"0055",3105,576,2529
"3196",3196,52,417,714,473,"0056",2699,660,2039
"3197",3197,25,248,350,274,"0057",2783,510,2273
"3198",3198,146,1348,2065,1502,"0058",2532,511,2021
"3199",3199,260,1822,2959,2098,"0059",3480,474,3006
"3200",3200,45,430,594,477,"0060",2772,922,1850
"3201",3201,330,1290,3201,1652,"0061",1875,358,1517
"3202",3202,321,895,2485,1232,"0062",3086,334,2752
"3203",3203,199,740,2112,953,"0063",4263,387,3876
"3204",3204,286,1026,2526,1330,"0064",4025,283,3742
"3205",3205,210,1093,2361,1323,"0065",2899,1299,1600
"3206",3206,17,134,237,153,"0066",3185,257,2928
"3207",3207,418,1421,2828,1877,"0067",3977,408,3569
"3208",3208,318,1052,2093,1398,"0068",1387,410,977
"3209",3209,401,1707,3023,2139,"0069",5461,302,5159
"3210",3210,374,1532,2815,1951,"0070",3253,304,2949
"3211",3211,588,2448,4419,3081,"0071",2464,230,2234
"3212",3212,414,1681,3175,2128,"0072",1978,106,1872
"3213",3213,298,1045,2087,1379,"0073",1748,90,1658
"3214",3214,177,809,1520,1007,"0074",3449,167,3282
"3215",3215,99,1261,1993,1384,"0075",1803,257,1546
"3216",3216,468,1571,3411,2081,"0076",1680,116,1564
"3217",3217,264,809,1763,1089,"0077",3712,349,3363
"3218",3218,504,915,2476,1445,"0078",1609,84,1525
"3219",3219,183,452,1152,652,"0079",1274,45,1229
"3220",3220,339,667,2133,1023,"0080",2030,29,2001
"3221",3221,90,162,713,260,"0081",567,6,561
"3222",3222,125,182,727,312,"0082",2691,69,2622
"3223",3223,232,365,1533,606,"0083",1967,52,1915
"3224",3224,411,765,2660,1200,"0084",2633,85,2548
"3225",3225,145,446,1080,606,"0085",2937,107,2830
"3226",3226,203,588,1377,813,"0086",5310,2800,2510
"3227",3227,174,603,1532,798,"0087",928,227,701
"3228",3228,178,453,1212,639,"0088A",5242,2181,3061
"3229",3229,218,653,1472,896,"0088B",16,7,9
"3230",3230,109,496,1140,617,"0089",4600,484,4116
"3231",3231,200,674,1454,884,"0090",1848,327,1521
"3232",3232,149,290,926,449,"0091",1052,149,903
"3233",3233,523,415,2164,958,"0092",4343,850,3493
"3234",3234,694,545,3069,1264,"0093",1751,202,1549
"3235",3235,247,662,1947,924,"0094",3523,509,3014
"3236",3236,202,212,1186,429,"0095",3345,534,2811
"3237",3237,501,777,2983,1312,"0096",3436,609,2827
"3238",3238,302,1013,2796,1344,"0097",2795,425,2370
"3239",3239,140,167,769,316,"0098",1913,344,1569
"3240",3240,180,470,1319,658,"0099",2184,202,1982
"3241",3241,136,211,927,361,"0100",4001,435,3566
"3242",3242,26,148,298,176,"0101",2838,428,2410
"3243",3243,43,294,442,339,"0102",3315,307,3008
"3244",3244,42,254,376,299,"0103",2269,473,1796
"3245",3245,57,197,380,258,"0104",4150,666,3484
"3246",3246,873,327,2131,1224,"0105",3000,385,2615
"3247",3247,16,66,128,83,"0106",3606,332,3274
"3248",3248,468,821,1964,1318,"0107",2519,326,2193
"3249",3249,0,0,0,0,"0108",2282,448,1834
"3250",3250,895,1561,3256,2510,"0109",2024,322,1702
"3251",3251,788,1376,2873,2215,"0110",4053,458,3595
"3252",3252,382,1109,2002,1510,"0111",4086,395,3691
"3253",3253,27,78,160,108,"0112",5575,320,5255
"3254",3254,511,1622,3298,2176,"0113",3297,297,3000
"3255",3255,569,975,2218,1571,"0114",6015,346,5669
"3256",3256,645,1329,2900,2000,"0115",4152,567,3585
"3257",3257,914,1215,3483,2177,"0116",5127,484,4643
"3258",3258,389,741,1800,1160,"0117",3681,370,3311
"3259",3259,267,1151,1821,1439,"0118",2703,347,2356
"3260",3260,520,1345,2812,1893,"0119",4107,440,3667
"3261",3261,526,451,1909,994,"0120",3844,292,3552
"3262",3262,610,1305,2886,1947,"0121",2153,189,1964
"3263",3263,666,714,2622,1406,"0122",4185,251,3934
"3264",3264,398,1009,2110,1433,"0123",4263,272,3991
"3265",3265,317,806,1762,1142,"0124",4588,285,4303
"3266",3266,219,769,1415,997,"0125",6309,403,5906
"3267",3267,595,1459,2997,2083,"0126",6267,506,5761
"3268",3268,0,0,0,0,"0127",1742,314,1428
"3269",3269,433,997,2186,1461,"0128",5351,618,4733
"3270",3270,648,1244,2863,1929,"0129",6299,839,5460
"3271",3271,533,1176,2772,1766,"0130",5253,434,4819
"3272",3272,562,1384,2524,1981,"0131",2938,221,2717
"3273",3273,417,1408,2503,1856,"0132",799,70,729
"3274",3274,101,331,632,434,"0133",3144,87,3057
"3275",3275,363,965,1969,1346,"0134",1660,89,1571
"3276",3276,108,308,669,423,"0135",3174,84,3090
"3277",3277,387,2025,3264,2452,"0136",2695,93,2602
"3278",3278,337,983,1706,1348,"0137",2214,53,2161
"3279",3279,736,2141,3811,2928,"0138",2924,107,2817
"3280",3280,364,1021,2098,1417,"0139",2605,123,2482
"3281",3281,770,1876,3625,2721,"0140",3157,97,3060
"3282",3282,330,804,1547,1163,"0141",1990,99,1891
"3283",3283,784,2075,3634,2918,"0142",1405,50,1355
"3284",3284,678,1841,3616,2578,"0143",2997,57,2940
"3285",3285,52,206,333,262,"0144",3258,122,3136
"3286",3286,443,1669,2713,2138,"0145",4069,158,3911
"3287",3287,92,224,401,320,"0146",1673,58,1615
"3288",3288,808,1944,3503,2812,"0147",2130,85,2045
"3289",3289,110,355,603,476,"0148",2740,99,2641
"3290",3290,27,92,152,120,"0149",3228,134,3094
"3291",3291,54,177,302,238,"0150",2638,108,2530
"3292",3292,80,201,389,285,"0151",3539,60,3479
"3293",3293,429,1053,2045,1517,"0152",3271,82,3189
"3294",3294,139,339,663,488,"0153",3097,80,3017
"3295",3295,1211,911,3217,2162,"0154",2611,32,2579
"3296",3296,1007,1155,3083,2209,"0155",1652,45,1607
"3297",3297,1090,668,2411,1786,"0156",4157,75,4082
"3298",3298,705,708,1928,1441,"0157",2143,64,2079
"3299",3299,945,843,2450,1824,"0158",1765,302,1463
"3300",3300,660,1671,3012,2375,"0159",3536,40,3496
"3301",3301,590,1541,2629,2175,"0160",3981,101,3880
"3302",3302,543,1123,2280,1702,"0161",1910,61,1849
"3303",3303,292,610,1244,924,"0162",5356,100,5256
"3304",3304,142,419,760,571,"0163",3812,71,3741
"3305",3305,790,377,2087,1199,"0164",4991,121,4870
"3306",3306,1042,622,3118,1711,"0165",5480,108,5372
"3307",3307,996,620,3009,1646,"0166",4407,541,3866
"3308",3308,580,366,1833,973,"0167",5857,135,5722
"3309",3309,1165,611,3213,1827,"0168",6000,419,5581
"3310",3310,759,843,2203,1628,"0169",6113,151,5962
"3311",3311,1127,765,2934,1927,"0170",4957,308,4649
"3312",3312,781,886,2768,1705,"0171",3998,53,3945
"3313",3313,1408,1113,3370,2575,"0172",5747,153,5594
"3314",3314,1649,610,4412,2315,"0173",2569,64,2505
"3315",3315,1636,739,3847,2438,"0174",5,0,5
"3316",3316,970,612,2593,1616,"0175",344,36,308
"3317",3317,1421,753,3383,2226,"0176",1132,286,846
"3318",3318,1613,1174,4109,2837,"0177",708,256,452
"3319",3319,1099,809,2772,1937,"0178",1478,243,1235
"3320",3320,1497,663,3645,2213,"0179",1113,25,1088
"3321",3321,717,493,1842,1246,"0180",3638,236,3402
"3322",3322,1255,1001,3307,2286,"0181",6391,927,5464
"3323",3323,1504,758,3914,2310,"0182",5662,1145,4517
"3324",3324,527,255,1176,796,"0183",0,0,0
"3325",3325,843,739,2267,1610,"0184",0,0,0
"3326",3326,1093,607,2881,1741,"0185",725,221,504
"3327",3327,598,450,1466,1067,"0186",965,177,788
"3328",3328,1364,919,3426,2349,"0187",0,0,0
"3329",3329,1183,654,3131,1887,"0188",159,35,124
"3330",3330,750,401,1793,1188,"0189",10,3,7
"3331",3331,854,289,2063,1172,"0190",0,0,0
"3332",3332,154,50,467,211,"0191",0,0,0
"3333",3333,1131,425,2844,1598,"0192",4922,832,4090
"3334",3334,91,12,223,104,"0193",2652,639,2013
"3335",3335,695,254,1866,980,"0194",3679,964,2715
"3336",3336,812,332,1871,1167,"0195",5895,1285,4610
"3337",3337,1036,390,1963,1446,"0196",4377,371,4006
"3338",3338,291,106,899,409,"0197",4599,271,4328
"3339",3339,972,382,2145,1402,"0198",4145,466,3679
"3340",3340,947,210,2305,1204,"0199",1201,268,933
"3341",3341,761,253,2946,1067,"0200",2607,287,2320
"3342",3342,845,236,2426,1117,"0201",3425,288,3137
"3343",3343,230,90,1089,334,"0202",3110,253,2857
"3344",3344,364,73,860,445,"0203",7318,587,6731
"3345",3345,410,103,1015,536,"0204",2017,116,1901
"3346",3346,619,202,2394,858,"0205",5655,217,5438
"3347",3347,806,683,2270,1538,"0206",1396,19,1377
"3348",3348,1122,730,3594,1900,"0207",3072,52,3020
"3349",3349,1425,762,3959,2251,"0208",3130,51,3079
"3350",3350,557,239,1590,817,"0010",2623,1925,698
"3351",3351,966,642,2769,1637,"0011",881,608,273
"3352",3352,764,307,2153,1099,"0012",1482,1249,233
"3353",3353,621,373,1995,1025,"0018",2053,1703,350
"3354",3354,845,431,2727,1319,"0019",1838,1435,403
"3355",3355,837,509,2503,1381,"0020",1762,1050,712
"3356",3356,841,419,2526,1296,"0021",2130,1267,863
"3357",3357,1054,518,3142,1626,"0023",761,486,275
"3358",3358,795,358,2608,1190,"0024",887,776,111
"3359",3359,870,569,2539,1475,"0025",933,674,259
"3360",3360,776,556,2367,1371,"0030",667,589,78
"3361",3361,535,299,1831,860,"0031",1437,1177,260
"3362",3362,611,402,2020,1043,"0032",2570,1865,705
"3363",3363,941,412,2891,1400,"0033",1640,1185,455
"3364",3364,776,707,2341,1512,"0034",1251,1097,154
"3365",3365,571,351,1589,953,"0035",385,208,177
"3366",3366,520,204,1896,744,"0041",769,663,106
"3367",3367,934,395,2889,1376,"0044",2210,1876,334
"3368",3368,997,335,3000,1367,"0045",4655,2811,1844
"3369",3369,203,218,1551,446,"0046",1261,872,389
"3370",3370,873,323,2438,1220,"0047",1642,1310,332
"3371",3371,843,353,2599,1227,"0101",1165,400,765
"3372",3372,260,98,744,367,"0104",762,609,153
"3373",3373,1586,537,4245,2194,"0105",1004,559,445
"3374",3374,1066,354,2633,1455,"0201",747,600,147
"3375",3375,898,275,2136,1201,"0203",987,348,639
"3376",3376,594,165,1633,785,"0204",1287,209,1078
"3377",3377,535,153,1362,707,"0301",708,557,151
"3378",3378,858,249,2551,1144,"0302",1663,695,968
"3379",3379,717,292,1581,1038,"0303",486,440,46
"3380",3380,523,181,1302,726,"0304",1440,821,619
"3381",3381,1001,339,2510,1373,"0403",1319,820,499
"3382",3382,521,208,1313,748,"0404",969,714,255
"3383",3383,263,67,826,338,"0405",909,549,360
"3384",3384,555,125,1618,712,"0001",4636,2812,1824
"3385",3385,113,50,427,167,"0002",1411,1264,147
"3386",3386,866,226,2319,1125,"0003",749,498,251
"3387",3387,517,129,1425,681,"0004",1647,1270,377
"3388",3388,891,226,2341,1146,"0005",659,607,52
"3389",3389,633,178,2018,841,"0006",770,683,87
"3390",3390,101,105,972,217,"0007",610,509,101
"3391",3391,5,1,20,6,"0009",1022,885,137
"3392",3392,260,285,2110,577,"0010",3033,2447,586
"3393",3393,1289,439,3329,1776,"0011",2959,2394,565
"3394",3394,823,436,1763,1283,"0012",1363,1213,150
"3395",3395,394,162,814,564,"0013",983,849,134
"3396",3396,1280,722,3242,2039,"0015",1059,906,153
"3397",3397,676,302,1632,1005,"0016",352,325,27
"3398",3398,1145,475,2818,1645,"0018",4511,3404,1107
"3399",3399,1190,551,2820,1780,"0019",2363,1816,547
"3400",3400,1285,752,3166,2080,"0002",237,182,55
"3401",3401,805,370,2031,1198,"0003",442,340,102
"3402",3402,842,480,1974,1355,"0004",748,672,76
"3403",3403,527,249,1468,804,"0005",261,231,30
"3404",3404,1349,559,3353,1962,"0006",493,435,58
"3405",3405,993,540,2448,1557,"0007",576,523,53
"3406",3406,982,409,2642,1419,"0008",442,354,88
"3407",3407,736,461,1902,1222,"0009",295,251,44
"3408",3408,1137,620,3098,1804,"0010",678,563,115
"3409",3409,1116,529,2740,1681,"0011",455,394,61
"3410",3410,1198,531,3085,1761,"0012",558,342,216
"3411",3411,927,410,2209,1360,"0013",861,641,220
"3412",3412,804,526,1999,1359,"0014",253,187,66
"3413",3413,776,388,1869,1185,"0015",365,336,29
"3414",3414,1317,602,3182,1949,"0016",1825,1053,772
"3415",3415,493,216,1322,717,"0017",468,409,59
"3416",3416,2026,787,5492,2877,"001E",1218,845,373
"3417",3417,1135,473,2723,1631,"001N",2806,1840,966
"3418",3418,1925,752,5044,2727,"001W",869,695,174
"3419",3419,1045,546,2859,1623,"0020",823,674,149
"3420",3420,1657,788,4252,2496,"0021",243,215,28
"3421",3421,1303,574,3212,1927,"0022",189,173,16
"3422",3422,1044,459,2412,1534,"0023",225,215,10
"3423",3423,987,460,2545,1477,"0024",279,252,27
"3424",3424,1298,520,3177,1858,"0025",3136,2126,1010
"3425",3425,878,310,1932,1208,"0026",651,456,195
"3426",3426,1573,608,3863,2221,"0001",732,521,211
"3427",3427,1304,476,3420,1812,"0004",831,633,198
"3428",3428,1391,470,3549,1898,"0010",602,370,232
"3429",3429,1623,688,4048,2348,"0012",697,486,211
"3430",3430,1937,967,4589,2957,"0001",1190,747,443
"3431",3431,65,41,253,109,"0009",91,70,21
"3432",3432,1459,846,3862,2346,"0018",1020,541,479
"3433",3433,1629,864,4315,2540,"0023",860,213,647
"3434",3434,1667,716,4158,2423,"0024",449,123,326
"3435",3435,1267,533,3000,1835,"024BA",319,42,277
"3436",3436,167,53,514,228,"024BB",0,0,0
"3437",3437,1066,264,2692,1362,"0101",186,151,35
"3438",3438,478,206,1347,701,"0201",186,153,33
"3439",3439,927,265,2558,1225,"0301",257,204,53
"3440",3440,717,198,2126,939,"0401",270,219,51
"3441",3441,818,210,2126,1058,"1001",3313,1424,1889
"3442",3442,902,229,2451,1168,"1002",794,61,733
"3443",3443,852,302,2265,1189,"1003",5322,251,5071
"3444",3444,701,223,2123,968,"1007",1616,784,832
"3445",3445,527,176,1495,724,"1008",1205,736,469
"3446",3446,458,134,1300,611,"1010",5153,3188,1965
"3447",3447,1031,241,2553,1318,"1012",4145,908,3237
"3448",3448,1068,322,2726,1418,"1013",4035,1278,2757
"3449",3449,1008,341,2813,1387,"1015",1829,885,944
"3450",3450,525,158,1490,701,"1018",2852,1666,1186
"3451",3451,581,216,1652,814,"1021",776,597,179
"3452",3452,937,274,2411,1240,"1024",1457,638,819
"3453",3453,1045,341,2869,1418,"1025",6388,1907,4481
"3454",3454,703,216,2009,947,"1037",4753,1229,3524
"3455",3455,887,272,2596,1180,"1040",4457,349,4108
"3456",3456,834,211,2397,1061,"1048",3628,517,3111
"3457",3457,1028,301,2697,1367,"1054",759,181,578
"3458",3458,900,251,2276,1184,"1058",2512,325,2187
"3459",3459,393,126,1080,535,"1067",3649,847,2802
"3460",3460,701,191,1891,914,"1068",577,376,201
"3461",3461,209,61,624,280,"1072",109,69,40
"3462",3462,629,451,1684,1100,"1073",1909,741,1168
"3463",3463,597,238,2017,863,"1074",5865,1591,4274
"3464",3464,892,347,2534,1274,"1076",7038,1679,5359
"3465",3465,362,178,1297,557,"1085",3955,1705,2250
"3466",3466,1297,449,3774,1790,"1087",1902,1183,719
"3467",3467,912,409,3016,1359,"1094",18,5,13
"3468",3468,1203,471,3712,1718,"1097",5174,2557,2617
"3469",3469,1270,453,3983,1780,"1103",6550,3371,3179
"3470",3470,856,644,3250,1548,"1109",1312,399,913
"3471",3471,1207,475,3941,1751,"1114",5098,249,4849
"3472",3472,137,69,394,208,"1118",7320,3630,3690
"3473",3473,886,372,3064,1297,"1120",2996,2007,989
"3474",3474,1021,638,3233,1702,"1128",3562,2265,1297
"3475",3475,779,285,2528,1109,"1134",5511,913,4598
"3476",3476,1272,576,4384,1900,"1141",4125,2149,1976
"3477",3477,446,277,1619,742,"1152",11084,3415,7669
"3478",3478,15,13,63,30,"1153",2425,85,2340
"3479",3479,107,37,268,149,"1154",4338,1200,3138
"3480",3480,446,269,1093,730,"2016",4677,901,3776
"3481",3481,228,131,540,367,"2017",3024,92,2932
"3482",3482,380,287,1291,687,"2022",3785,1749,2036
"3483",3483,228,60,722,302,"2023",4103,100,4003
"3484",3484,713,271,2201,1004,"2031",3538,80,3458
"3485",3485,1415,840,3685,2315,"2033",1154,285,869
"3486",3486,864,387,2304,1288,"2034",5267,208,5059
"3487",3487,1,0,0,1,"2036",1140,36,1104
"3488",3488,1,0,0,1,"2043",1551,208,1343
"3489",3489,248,202,654,459,"2050",3011,78,2933
"3490",3490,277,159,802,450,"2051",2735,50,2685
"3491",3491,0,0,0,0,"2052",3084,110,2974
"3492",3492,37,27,112,67,"2055",1282,18,1264
"3493",3493,47,24,133,76,"2056",1394,122,1272
"3494",3494,42,14,115,57,"2059",2522,114,2408
"3495",3495,218,107,513,330,"2060",5794,561,5233
"3496",3496,1570,1115,4105,2738,"2061",5599,1873,3726
"3497",3497,860,597,2136,1478,"2066",6387,495,5892
"3498",3498,999,633,3062,1686,"2070",2643,540,2103
"3499",3499,1157,737,3985,1953,"2075",2330,97,2233
"3500",3500,1152,532,3174,1726,"2077",2325,163,2162
"3501",3501,1493,619,3886,2160,"2078",793,52,741
"3502",3502,1081,528,2849,1651,"2081",1933,270,1663
"3503",3503,434,327,1203,768,"2088",3677,517,3160
"3504",3504,100,44,234,150,"2089",1321,28,1293
"3505",3505,903,500,2194,1432,"2090",730,358,372
"3506",3506,987,592,2508,1605,"2091",765,225,540
"3507",3507,1999,1105,4650,3156,"2092",904,303,601
"3508",3508,525,315,1268,851,"2093",650,136,514
"3509",3509,1170,499,3345,1715,"2096",4690,967,3723
"3510",3510,249,114,797,368,"2099",5092,666,4426
"3511",3511,659,226,2035,918,"2100",3800,525,3275
"3512",3512,487,209,1905,731,"2101",5626,520,5106
"3513",3513,83,84,785,177,"2106",8068,888,7180
"3514",3514,0,0,0,0,"2108",7559,1117,6442
"3515",3515,0,0,0,0,"2112",1509,36,1473
"3516",3516,70,45,270,119,"2115",2170,366,1804
"3517",3517,0,0,0,0,"2116",2198,61,2137
"3518",3518,414,213,965,641,"2123",2747,50,2697
"3519",3519,79,32,230,114,"2136",372,95,277
"3520",3520,2,1,5,3,"2137",1002,99,903
"3521",3521,1274,734,3717,2042,"2138A",564,47,517
"3522",3522,9,2,29,12,"2138B",9,1,8
"3523",3523,113,50,398,169,"2139A",68,6,62
"3524",3524,48,24,170,74,"2139B",14,1,13
"3525",3525,492,134,1334,642,"2151",2846,687,2159
"3526",3526,439,122,1279,575,"2157",4831,982,3849
"3527",3527,60,64,571,129,"3004",4126,2164,1962
"3528",3528,204,530,1188,748,"3005",4346,2972,1374
"3529",3529,104,271,634,390,"3006",11773,6369,5404
"3530",3530,156,737,1235,912,"3009A",3028,2010,1018
"3531",3531,200,1168,1861,1387,"3009B",0,0,0
"3532",3532,138,891,1459,1044,"3014",8222,4079,4143
"3533",3533,154,697,1332,871,"3019",1057,658,399
"3534",3534,157,800,1517,973,"3032",3983,664,3319
"3535",3535,65,308,574,380,"3038",8055,3030,5025
"3536",3536,252,909,1629,1182,"3041",2015,1377,638
"3537",3537,64,502,774,574,"3053",85,55,30
"3538",3538,58,449,640,513,"3057",6255,2887,3368
"3539",3539,121,827,1270,962,"3063",3332,2387,945
"3540",3540,183,961,1783,1176,"3069",475,194,281
"3541",3541,215,390,1008,622,"3083",6079,1524,4555
"3542",3542,125,893,1232,1034,"3095",5818,1993,3825
"3543",3543,40,56,204,100,"3098",4115,762,3353
"3544",3544,62,550,756,618,"3104",6028,3487,2541
"3545",3545,174,1473,2091,1670,"3113",10176,594,9582
"3546",3546,288,736,1526,1062,"3122",3773,2721,1052
"3547",3547,107,374,821,496,"3130",6063,2889,3174
"3548",3548,49,162,319,216,"3132",6584,2823,3761
"3549",3549,152,159,736,315,"3133",4105,2481,1624
"3550",3550,220,321,973,544,"3142",5262,2153,3109
"3551",3551,61,449,730,515,"3143",8513,3117,5396
"3552",3552,82,366,646,451,"3144",5306,2615,2691
"3553",3553,370,162,1210,534,"3145",4027,1621,2406
"3554",3554,304,134,871,444,"3146",8191,3130,5061
"3555",3555,89,429,836,521,"3148",12547,6081,6466
"3556",3556,188,607,1352,799,"3149",4991,3986,1005
"3557",3557,37,380,550,419,"3150",9358,1844,7514
"3558",3558,82,331,659,422,"3156",2404,1754,650
"3559",3559,178,492,1096,681,"3159",4183,1251,2932
"3560",3560,136,347,679,490,"3160",3078,1384,1694
"3561",3561,214,795,1643,1034,"4011",1613,805,808
"3562",3562,103,841,1363,956,"4020",3416,1902,1514
"3563",3563,132,284,638,424,"4026",3154,1368,1786
"3564",3564,276,776,1602,1074,"4027",0,0,0
"3565",3565,63,366,639,436,"4028",2437,1177,1260
"3566",3566,85,478,780,572,"4029",1939,1297,642
"3567",3567,49,296,494,348,"4030",2826,1618,1208
"3568",3568,96,611,1029,720,"4035",2198,601,1597
"3569",3569,316,1598,2731,1948,"4039",1056,351,705
"3570",3570,267,1451,2594,1760,"4042",1263,853,410
"3571",3571,114,761,1198,886,"4044",4694,867,3827
"3572",3572,63,301,520,370,"4045",2255,807,1448
"3573",3573,74,597,921,687,"4046",3780,1484,2296
"3574",3574,33,203,362,238,"4047",895,290,605
"3575",3575,101,424,792,537,"4049A",4356,763,3593
"3576",3576,376,1389,2957,1813,"4049B",0,0,0
"3577",3577,293,1000,1889,1314,"4062",3817,1210,2607
"3578",3578,413,994,2057,1422,"4064",1362,621,741
"3579",3579,119,665,998,797,"4065",6403,1601,4802
"3580",3580,187,678,1218,875,"4071",837,106,731
"3581",3581,166,723,1249,903,"4079",493,176,317
"3582",3582,184,923,1423,1122,"4080",1916,601,1315
"3583",3583,262,1222,1879,1498,"4082",8444,3946,4498
"3584",3584,280,1014,1730,1311,"4084",1696,649,1047
"3585",3585,87,450,665,543,"4086",3879,571,3308
"3586",3586,321,1157,2027,1492,"4102",2691,480,2211
"3587",3587,93,466,686,560,"4105",2690,963,1727
"3588",3588,133,518,838,659,"4107",2032,1035,997
"3589",3589,405,1352,2582,1780,"4110",3720,1413,2307
"3590",3590,66,365,629,433,"4111",1604,737,867
"3591",3591,78,359,624,445,"4117",8402,2009,6393
"3592",3592,96,350,664,454,"4119",3146,1637,1509
"3593",3593,0,0,0,0,"4121",1289,527,762
"3594",3594,112,374,728,494,"4124",7633,2116,5517
"3595",3595,106,502,949,611,"4125",5373,999,4374
"3596",3596,102,531,1073,637,"4126",4421,1049,3372
"3597",3597,115,240,873,360,"4127",3360,914,2446
"3598",3598,115,311,949,432,"4129",8620,2279,6341
"3599",3599,26,84,192,117,"4131",1990,923,1067
"3600",3600,24,153,254,178,"4135",7674,1684,5990
"3601",3601,21,98,208,121,"4140",3336,1466,1870
"3602",3602,28,110,229,142,"4147",9168,1329,7839
"3603",3603,1164,1617,3729,2833,"4155",4069,384,3685
"3604",3604,345,940,1542,1303,"4158",2899,371,2528
"3605",3605,2972,5072,9927,8188,"0101",1365,1116,249
"3606",3606,171,550,1003,731,"0102",556,463,93
"3607",3607,929,991,3034,1968,"0201",606,506,100
"3608",3608,1921,3168,6459,5181,"0202",1226,754,472
"3609",3609,198,574,1047,782,"0301",991,782,209
"3610",3610,2011,2332,5967,4435,"0302",1108,878,230
"3611",3611,465,1061,2009,1547,"0401",1303,1132,171
"3612",3612,116,169,478,296,"0402",868,712,156
"3613",3613,1752,2267,5177,4094,"0001",3536,2603,933
"3614",3614,777,1799,3317,2621,"0002",1760,1028,732
"3615",3615,1723,2703,5872,4511,"0003",182,144,38
"3616",3616,1687,2534,5447,4303,"0004",396,328,68
"3617",3617,1167,1794,3850,3028,"0005",3942,2251,1691
"3618",3618,1722,2259,5423,4065,"0006",583,494,89
"3619",3619,1820,2027,5215,3928,"0007",980,677,303
"3620",3620,1211,1798,3901,3076,"0008",668,586,82
"3621",3621,1549,1787,4301,3408,"0009",753,507,246
"3622",3622,2463,2758,6628,5317,"0010",398,314,84
"3623",3623,1418,1991,4308,3473,"0011",691,357,334
"3624",3624,1002,1137,2908,2172,"0012",204,148,56
"3625",3625,2394,2566,6524,5063,"0013",381,316,65
"3626",3626,3205,4907,10042,8251,"0014",468,387,81
"3627",3627,0,0,0,0,"0015",350,291,59
"3628",3628,919,3447,5182,4431,"0001",1523,242,1281
"3629",3629,578,1345,2448,1951,"0002",2555,130,2425
"3630",3630,1096,1162,2958,2304,"0003",971,27,944
"3631",3631,936,818,2468,1788,"0004A",1643,477,1166
"3632",3632,588,1580,2608,2204,"0004B",65,33,32
"3633",3633,1270,303,2743,1598,"0005",803,412,391
"3634",3634,511,713,1577,1239,"0006",670,328,342
"3635",3635,1060,1704,3486,2829,"0008",1403,212,1191
"3636",3636,522,2117,3767,2689,"0009",1365,141,1224
"3637",3637,1586,110,2719,1716,"0010",2827,532,2295
"3638",3638,320,1246,2298,1585,"0002",3029,1832,1197
"3639",3639,68,507,742,587,"0003",3760,2625,1135
"3640",3640,1159,181,2546,1355,"0004",2456,1191,1265
"3641",3641,1011,790,2423,1839,"0005",244,156,88
"3642",3642,1069,1073,2810,2191,"0006",679,232,447
"3643",3643,1656,143,2973,1827,"0007",849,121,728
"3644",3644,619,246,1232,881,"0008",1207,669,538
"3645",3645,2866,261,4248,3167,"0009",1911,1310,601
"3646",3646,673,45,1178,729,"0103",1278,1130,148
"3647",3647,1969,103,3065,2103,"0104",1168,966,202
"3648",3648,1564,84,2389,1680,"0105",676,392,284
"3649",3649,1545,114,2713,1683,"0142",3483,1706,1777
"3650",3650,679,34,1170,724,"0144",3181,1878,1303
"3651",3651,316,112,943,439,"0146",3555,1989,1566
"3652",3652,961,239,1640,1221,"0148",4786,2530,2256
"3653",3653,1415,140,2364,1580,"0150",3176,1751,1425
"3654",3654,1980,1508,4393,3540,"0151",4959,3131,1828
"3655",3655,30,332,475,370,"0152",4928,3735,1193
"3656",3656,687,462,1783,1164,"0159",7120,3778,3342
"3657",3657,1182,134,2002,1345,"0165",6267,4113,2154
"3658",3658,1287,210,2050,1521,"0166",3187,2393,794
"3659",3659,669,261,1408,946,"0167",7497,5547,1950
"3660",3660,1181,1136,3406,2367,"0168",12,1,11
"3661",3661,656,939,1986,1632,"0169",0,0,0
"3662",3662,694,284,1525,991,"0170",2918,2117,801
"3663",3663,938,56,1350,1005,"0172",961,589,372
"3664",3664,293,266,743,570,"0192",1195,499,696
"3665",3665,318,169,675,502,"0193",3247,2193,1054
"3666",3666,3,1,7,4,"0197",1431,829,602
"3667",3667,2031,1894,5138,4018,"0218",3796,2165,1631
"3668",3668,3580,1224,6207,4882,"0219",3489,1597,1892
"3669",3669,397,355,1006,765,"0220",7900,4400,3500
"3670",3670,2621,275,4234,2930,"0221",2066,1788,278
"3671",3671,978,289,1876,1287,"0223",4653,2262,2391
"3672",3672,1355,115,2153,1494,"0224",4714,2701,2013
"3673",3673,2882,2808,6980,5781,"0225A",3348,2697,651
"3674",3674,952,1531,3124,2519,"0225B",0,0,0
"3675",3675,1363,101,2565,1482,"0226",3306,2080,1226
"3676",3676,1015,1790,3498,2857,"0227",3967,3115,852
"3677",3677,2286,764,4045,3110,"0228",3606,2924,682
"3678",3678,173,71,370,248,"0232",2569,1201,1368
"3679",3679,1361,688,2654,2076,"0258",2819,2231,588
"3680",3680,3724,2993,8881,6856,"0263",8622,5555,3067
"3681",3681,1424,112,2182,1560,"0274",993,877,116
"3682",3682,93,386,677,486,"0275",384,341,43
"3683",3683,1106,895,2527,2027,"0276",2743,1964,779
"3684",3684,552,658,1605,1245,"0277",2961,2390,571
"3685",3685,1568,1254,4060,2882,"0278",3137,2483,654
"3686",3686,881,1425,3147,2362,"0279",1557,1156,401
"3687",3687,1166,1308,3375,2534,"0280",2027,950,1077
"3688",3688,10,13,29,24,"0281",252,170,82
"3689",3689,577,882,1879,1508,"0283",4357,2460,1897
"3690",3690,720,675,1951,1431,"0301",1533,545,988
"3691",3691,285,515,1109,815,"0306",6908,3901,3007
"3692",3692,388,150,894,551,"0309",114,77,37
"3693",3693,1758,1370,3896,3178,"0311",3948,1567,2381
"3694",3694,795,610,2026,1440,"0312",6,0,6
"3695",3695,1310,1099,3381,2461,"0314",5022,1979,3043
"3696",3696,397,253,884,661,"0315",4865,2224,2641
"3697",3697,1750,909,3732,2707,"0316A",3638,936,2702
"3698",3698,0,1,10,1,"0316B",12,3,9
"3699",3699,1678,722,3617,2437,"0330",3998,1323,2675
"3700",3700,1658,1089,3643,2792,"0331",2921,602,2319
"3701",3701,1101,1135,3045,2285,"0334",1840,389,1451
"3702",3702,2524,1837,5574,4439,"0336",4650,702,3948
"3703",3703,0,0,0,0,"0338",6663,2294,4369
"3704",3704,274,189,619,467,"0340",1010,86,924
"3705",3705,280,151,638,434,"0341",3090,835,2255
"3706",3706,190,156,479,353,"0343",3752,1266,2486
"3707",3707,634,478,1480,1134,"0345",1385,300,1085
"3708",3708,665,546,1602,1232,"0347",2839,887,1952
"3709",3709,1174,638,2625,1842,"0389",929,238,691
"3710",3710,369,202,824,576,"0391",367,80,287
"3711",3711,261,84,491,349,"0394",54,18,36
"3712",3712,1240,530,2770,1815,"0398",770,241,529
"3713",3713,1114,663,2808,1819,"0399",571,91,480
"3714",3714,1133,692,2475,1861,"0401",62,43,19
"3715",3715,247,197,582,453,"0439",4273,2774,1499
"3716",3716,633,916,1965,1580,"0453",7323,4483,2840
"3717",3717,1038,902,2719,1987,"0454",5411,3154,2257
"3718",3718,493,519,1442,1042,"0455",2640,1547,1093
"3719",3719,210,65,651,281,"0456",3594,2851,743
"3720",3720,1154,1420,3306,2621,"0457",4681,3505,1176
"3721",3721,340,205,802,556,"0460",5294,4208,1086
"3722",3722,1969,1111,4346,3124,"0461",3699,2833,866
"3723",3723,378,233,865,621,"0462",5154,3735,1419
"3724",3724,1326,923,2975,2300,"0464",3153,2184,969
"3725",3725,4,5,12,9,"0471",3616,2003,1613
"3726",3726,3227,2310,6892,5624,"0482",296,191,105
"3727",3727,668,530,1586,1227,"0487",7216,4582,2634
"3728",3728,0,0,0,0,"0488",4628,2857,1771
"3729",3729,3252,2053,6668,5416,"0490",5555,3633,1922
"3730",3730,237,113,587,353,"1051",723,507,216
"3731",3731,239,103,435,347,"1651",0,0,0
"3732",3732,757,374,1430,1148,"2321",0,0,0
"3733",3733,1135,1313,3182,2506,"2322",0,0,0
"3734",3734,2360,1138,4404,3549,"2323",473,388,85
"3735",3735,1301,676,3025,2014,"2801",0,0,0
"3736",3736,447,360,1019,817,"3061",22,11,11
"3737",3737,1353,588,2387,1963,"3301",0,0,0
"3738",3738,50,40,118,92,"3311",371,160,211
"3739",3739,239,184,537,432,"4391",22,13,9
"3740",3740,288,155,604,454,"0001",619,414,205
"3741",3741,792,398,1842,1205,"0002",813,554,259
"3742",3742,753,462,1712,1234,"0003",2489,416,2073
"3743",3743,643,260,1423,923,"0004",584,173,411
"3744",3744,606,945,2267,1592,"0005",131,104,27
"3745",3745,344,57,671,415,"0006",153,137,16
"3746",3746,675,764,2805,1478,"0001",2675,2121,554
"3747",3747,249,748,1473,1008,"0002",1536,1054,482
"3748",3748,60,202,393,266,"0003",1572,1132,440
"3749",3749,1319,1700,4607,3085,"0004",2917,2305,612
"3750",3750,1244,1127,3127,2429,"0005",1836,1580,256
"3751",3751,580,292,1353,887,"0006",698,528,170
"3752",3752,730,915,2991,1679,"0007",3214,2500,714
"3753",3753,474,253,1018,736,"0008",347,261,86
"3754",3754,967,305,2781,1311,"0009",171,147,24
"3755",3755,690,384,2222,1109,"0010",1329,994,335
"3756",3756,2312,857,4914,3244,"0012",2700,2083,617
"3757",3757,1464,830,3199,2327,"0013",2151,1726,425
"3758",3758,2356,1366,4893,3792,"0015",775,706,69
"3759",3759,17,61,114,78,"0001",229,172,57
"3760",3760,331,524,1345,872,"0002",220,136,84
"3761",3761,0,0,0,0,"0003",192,139,53
"3762",3762,1642,1185,4294,2884,"0004",203,117,86
"3763",3763,1380,777,2976,2197,"0011",940,364,576
"3764",3764,2460,2912,6953,5459,"0012",450,303,147
"3765",3765,2261,1267,4828,3593,"0021",904,396,508
"3766",3766,1727,1506,4204,3301,"0022",268,127,141
"3767",3767,1516,920,3803,2506,"0031",882,612,270
"3768",3768,1216,614,3045,1874,"0032",619,525,94
"3769",3769,1722,668,3976,2433,"0041",366,301,65
"3770",3770,2742,1182,5526,3999,"0042",695,571,124
"3771",3771,3619,1226,6924,4934,"0043",376,306,70
"3772",3772,696,399,1448,1118,"0001",3135,1611,1524
"3773",3773,1741,927,3619,2717,"0002",2317,1013,1304
"3774",3774,1287,1480,3226,2809,"0003",2127,797,1330
"3775",3775,3493,1656,7038,5215,"0005",697,525,172
"3776",3776,1260,995,3342,2302,"0007",560,377,183
"3777",3777,111,347,679,464,"0008",411,249,162
"3778",3778,594,337,1281,946,"0009",1268,435,833
"3779",3779,641,357,1377,1016,"0010",687,341,346
"3780",3780,10,3,25,15,"0011",259,194,65
"3781",3781,112,55,210,170,"0012",200,111,89
"3782",3782,522,321,1195,859,"0013",390,263,127
"3783",3783,152,740,1278,909,"0014",119,70,49
"3784",3784,41,362,515,406,"0015",371,247,124
"3785",3785,56,385,597,445,"04/6",2148,635,1513
"3786",3786,137,485,1008,633,"0001",506,427,79
"3787",3787,75,460,756,538,"0002",4687,2473,2214
"3788",3788,96,489,860,596,"0003",137,120,17
"3789",3789,155,756,1198,918,"0004",709,615,94
"3790",3790,92,484,812,585,"0005",3368,2581,787
"3791",3791,336,1678,2907,2052,"0006",3146,2349,797
"3792",3792,234,959,1767,1218,"0007",3549,1987,1562
"3793",3793,6,112,154,118,"0101",6917,3327,3590
"3794",3794,34,256,383,291,"0102",4050,1503,2547
"3795",3795,4,26,39,30,"0103",652,530,122
"3796",3796,267,899,1735,1177,"0104",965,803,162
"3797",3797,134,425,836,565,"0105",6537,5356,1181
"3798",3798,39,314,497,357,"0106",3663,2738,925
"3799",3799,2,15,24,17,"0107",2074,1786,288
"3800",3800,0,0,0,0,"0108",1800,1592,208
"3801",3801,102,394,779,510,"0201",4468,3262,1206
"3802",3802,7,39,70,46,"0202",4707,3580,1127
"3803",3803,71,360,562,438,"0203",1708,1037,671
"3804",3804,31,124,228,156,"0204",1239,1047,192
"3805",3805,30,114,216,145,"0205A",4420,3794,626
"3806",3806,0,3,5,3,"0205B",14,8,6
"3807",3807,21,228,320,251,"0206",1417,1184,233
"3808",3808,120,165,444,290,"0207",1163,952,211
"3809",3809,87,134,338,223,"0208",1785,1440,345
"3810",3810,0,0,0,0,"0209",1420,1202,218
"3811",3811,81,538,829,626,"0210",2351,1994,357
"3812",3812,29,208,329,243,"0301",3166,2087,1079
"3813",3813,408,383,1302,796,"0302",8116,5361,2755
"3814",3814,335,209,1013,550,"0303",1143,899,244
"3815",3815,275,127,759,407,"0304",4055,2778,1277
"3816",3816,302,398,1102,704,"0305",1674,1422,252
"3817",3817,110,318,548,428,"0306",4675,3964,711
"3818",3818,102,299,602,402,"0307",2537,2168,369
"3819",3819,411,385,1387,799,"0308",1467,1112,355
"3820",3820,306,303,1176,614,"0309",1131,699,432
"3821",3821,173,401,1066,577,"0401",2308,1453,855
"3822",3822,106,1144,1886,1263,"0402",3261,2441,820
"3823",3823,117,1716,2567,1846,"0403",3361,2993,368
"3824",3824,123,1134,2208,1275,"0404",3949,3472,477
"3825",3825,12,145,229,158,"0405",939,571,368
"3826",3826,35,114,381,151,"0406",3180,2864,316
"3827",3827,150,713,1716,877,"0407",457,272,185
"3828",3828,33,389,685,426,"0408A",1743,1396,347
"3829",3829,751,1619,3119,2412,"0408B",327,268,59
"3830",3830,1343,1121,4647,2519,"0409",5084,3779,1305
"3831",3831,672,550,2631,1245,"0001",2525,1554,971
"3832",3832,539,1196,2683,1766,"0002",4657,3364,1293
"3833",3833,786,1294,3234,2120,"0003",5135,3402,1733
"3834",3834,966,1534,4208,2568,"0004",3538,2812,726
"3835",3835,621,985,2586,1634,"0005",5226,3592,1634
"3836",3836,574,1724,3588,2338,"0006",2781,2064,717
"3837",3837,412,814,1707,1253,"0007",3917,2803,1114
"3838",3838,948,1809,4853,2794,"0008",5624,3789,1835
"3839",3839,572,1249,2393,1852,"0009",4792,3265,1527
"3840",3840,705,1529,3216,2290,"0010",7146,3589,3557
"3841",3841,734,1676,3492,2456,"0011",5584,3494,2090
"3842",3842,0,2,2,2,"0012",5188,4275,913
"3843",3843,90,283,508,376,"0013",4081,2937,1144
"3844",3844,252,481,1046,750,"0014",5121,3913,1208
"3845",3845,592,1333,2787,1963,"0015",2794,1326,1468
"3846",3846,829,1623,3395,2499,"0016",5314,3785,1529
"3847",3847,693,1324,2787,2063,"0017",1346,583,763
"3848",3848,555,80,1081,643,"0018",3723,1677,2046
"3849",3849,193,411,1007,620,"0019",5500,1237,4263
"3850",3850,613,388,1683,1028,"0020",5026,989,4037
"3851",3851,158,860,1385,1027,"0021",4985,1027,3958
"3852",3852,137,620,1021,765,"0001",2052,1693,359
"3853",3853,1673,1135,4605,2889,"0002",872,726,146
"3854",3854,581,273,1894,889,"0003",2667,413,2254
"3855",3855,1781,667,4347,2501,"0004",1491,1200,291
"3856",3856,1615,866,4271,2544,"0005",4520,2324,2196
"3857",3857,949,542,2703,1519,"0006",2531,1199,1332
"3858",3858,1243,1049,3427,2345,"0007",1457,1036,421
"3859",3859,520,1211,2255,1749,"0008",643,468,175
"3860",3860,1150,1047,3620,2241,"0009",336,220,116
"3861",3861,1194,1152,3703,2384,"0010",1719,1436,283
"3862",3862,514,1886,3219,2442,"0011",331,277,54
"3863",3863,540,1296,2854,1867,"0012",1066,641,425
"3864",3864,404,1939,3371,2374,"0014",2491,1824,667
"3865",3865,1018,569,3197,1608,"0015",869,634,235
"3866",3866,408,83,1144,499,"0101",751,474,277
"3867",3867,167,458,834,632,"0102A",1252,770,482
"3868",3868,97,195,371,295,"0102B",26,7,19
"3869",3869,766,972,2613,1774,"0103",902,555,347
"3870",3870,291,1596,2787,1915,"0104",1765,814,951
"3871",3871,438,2350,3967,2822,"0105",3730,2232,1498
"3872",3872,894,1768,3436,2716,"0106",4031,2350,1681
"3873",3873,332,53,712,397,"0107",1336,999,337
"3874",3874,386,474,1687,886,"0108",922,550,372
"3875",3875,1119,1968,4526,3165,"0109",763,556,207
"3876",3876,1305,1977,4762,3364,"0110",243,143,100
"3877",3877,749,1302,3102,2088,"0111",191,84,107
"3878",3878,735,2038,3593,2819,"0112",663,282,381
"3879",3879,999,2568,4816,3639,"0113",1566,930,636
"3880",3880,898,1781,3499,2729,"0114",1423,719,704
"3881",3881,745,1608,3237,2410,"0115",332,230,102
"3882",3882,726,1486,3033,2260,"0116",3309,1991,1318
"3883",3883,799,1099,2676,1940,"0117",5573,3521,2052
"3884",3884,274,489,1121,783,"0118",51,40,11
"3885",3885,594,1169,2303,1797,"0119",2044,1355,689
"3886",3886,823,1646,3180,2518,"0120",1369,914,455
"3887",3887,1085,1967,4353,3138,"0121",106,82,24
"3888",3888,284,150,778,438,"0122",47,42,5
"3889",3889,996,1901,4125,2966,"0123",3,0,3
"3890",3890,233,351,1039,587,"0124",9,0,9
"3891",3891,174,131,552,308,"0125",233,158,75
"3892",3892,91,86,400,180,"0126",26,19,7
"3893",3893,361,720,1417,1102,"0127",9,7,2
"3894",3894,6,1,3,7,"0201",869,262,607
"3895",3895,934,1097,2860,2066,"0202",1652,331,1321
"3896",3896,833,1354,3077,2232,"0203",1440,482,958
"3897",3897,364,596,1355,980,"0204",2262,509,1753
"3898",3898,382,2098,3377,2523,"0205",1589,899,690
"3899",3899,570,929,2113,1529,"0206",4353,906,3447
"3900",3900,1366,445,2973,1827,"0207",1741,450,1291
"3901",3901,643,698,2197,1362,"0208",4520,2925,1595
"3902",3902,639,203,1600,855,"0209",1594,197,1397
"3903",3903,520,397,1403,935,"0210",1025,480,545
"3904",3904,1845,266,3571,2132,"0211",124,79,45
"3905",3905,1499,952,4022,2507,"0212",182,70,112
"3906",3906,821,1670,3823,2540,"0213",3695,2169,1526
"3907",3907,170,918,1575,1098,"0214",760,431,329
"3908",3908,629,1939,3388,2627,"0215",1006,630,376
"3909",3909,741,2231,4007,3041,"0216",54,36,18
"3910",3910,688,1816,3171,2560,"0217",253,77,176
"3911",3911,152,784,1380,947,"0218",98,19,79
"3912",3912,426,537,1230,970,"0219",118,61,57
"3913",3913,38,107,217,146,"0220",149,52,97
"3914",3914,22,125,181,149,"0221",44,16,28
"3915",3915,981,1563,3655,2585,"0222",16,0,16
"3916",3916,348,1094,1912,1476,"0223",372,198,174
"3917",3917,478,1266,2222,1788,"0224",199,23,176
"3918",3918,1,2,3,3,"0225",32,9,23
"3919",3919,0,0,0,0,"0226",496,206,290
"3920",3920,54,287,456,345,"0301",4301,2086,2215
"3921",3921,0,0,0,0,"0302",5538,2571,2967
"3922",3922,0,0,0,0,"0303",1530,931,599
"3923",3923,6,13,23,20,"0304",4166,2368,1798
"3924",3924,0,0,0,0,"0305",4917,2488,2429
"3925",3925,41,351,582,395,"0306",3920,2197,1723
"3926",3926,55,424,712,480,"0307",4708,2354,2354
"3927",3927,55,290,653,348,"0308",2170,1352,818
"3928",3928,49,180,472,230,"0401",2464,1355,1109
"3929",3929,15,71,124,86,"0402",2523,1219,1304
"3930",3930,16,97,135,114,"0403",3734,1897,1837
"3931",3931,422,1214,2085,1655,"0404",4218,2093,2125
"3932",3932,287,795,1512,1095,"0405",2526,1680,846
"3933",3933,224,689,1372,924,"0406",2126,1675,451
"3934",3934,642,1832,3305,2499,"0407",2199,1526,673
"3935",3935,152,1248,1795,1417,"0408",5553,3360,2193
"3936",3936,96,427,694,526,"0409",6289,2501,3788
"3937",3937,402,1766,2745,2190,"0410",164,81,83
"3938",3938,44,229,349,276,"0411",3858,1910,1948
"3939",3939,16,147,194,164,"0101",517,164,353
"3940",3940,150,605,1008,766,"0102",199,52,147
"3941",3941,335,1674,2492,2022,"0103",864,123,741
"3942",3942,255,1370,2003,1641,"0104",967,267,700
"3943",3943,152,518,786,677,"0105",295,86,209
"3944",3944,7,170,199,181,"0110",403,261,142
"3945",3945,10,123,178,134,"0111",1522,425,1097
"3946",3946,8,169,218,180,"0112",2051,827,1224
"3947",3947,14,149,203,166,"0202",692,75,617
"3948",3948,252,386,1048,646,"0203",970,107,863
"3949",3949,35,313,465,351,"0204",1204,266,938
"3950",3950,252,488,1185,756,"0205",344,38,306
"3951",3951,52,125,289,178,"0206",250,17,233
"3952",3952,99,355,662,456,"0213",477,172,305
"3953",3953,52,437,633,496,"0214",867,311,556
"3954",3954,45,260,397,309,"0215",530,183,347
"3955",3955,53,436,638,498,"0304",1077,495,582
"3956",3956,37,285,427,324,"0305",1214,740,474
"3957",3957,426,1316,2728,1771,"0306",142,36,106
"3958",3958,340,695,1914,1062,"0307",712,253,459
"3959",3959,278,719,1716,1009,"0308",89,44,45
"3960",3960,86,366,693,456,"0316",1455,588,867
"3961",3961,61,266,462,334,"0317",166,115,51
"3962",3962,52,209,392,266,"0318",1285,782,503
"3963",3963,298,388,1220,697,"0406",1458,222,1236
"3964",3964,74,313,661,391,"0407",1592,943,649
"3965",3965,15,165,224,182,"0408",871,453,418
"3966",3966,32,105,187,138,"0409",1163,357,806
"3967",3967,43,229,364,274,"0419",322,204,118
"3968",3968,8,59,81,68,"0420",445,322,123
"3969",3969,32,241,362,277,"0101",494,254,240
"3970",3970,203,556,1579,772,"0201",76,58,18
"3971",3971,15,289,416,308,"0202",500,328,172
"3972",3972,154,1391,2635,1570,"0301",138,82,56
"3973",3973,1,100,112,104,"0302",436,274,162
"3974",3974,39,442,719,485,"0401",314,226,88
"3975",3975,205,1842,3135,2081,"0402",241,157,84
"3976",3976,202,1731,2813,1950,"0001",1179,1015,164
"3977",3977,213,1045,2547,1284,"0004",194,166,28
"3978",3978,447,585,1855,1052,"0005",128,116,12
"3979",3979,683,428,2240,1133,"0007",1715,1389,326
"3980",3980,512,640,2044,1175,"0009",201,188,13
"3981",3981,130,737,1170,880,"0012",180,163,17
"3982",3982,157,633,1041,808,"0014",200,178,22
"3983",3983,382,1688,2898,2111,"0015",241,195,46
"3984",3984,195,1242,1991,1457,"0017",240,187,53
"3985",3985,291,1608,2473,1929,"0022",1055,957,98
"3986",3986,693,2821,4618,3565,"0023",1158,952,206
"3987",3987,721,1507,3609,2279,"0001",970,463,507
"3988",3988,716,1772,4044,2537,"0002",71,50,21
"3989",3989,264,380,1348,661,"0003",300,185,115
"3990",3990,10,64,104,74,"0004",761,430,331
"3991",3991,524,2303,4034,2867,"0005",664,323,341
"3992",3992,457,826,2039,1305,"0006",820,439,381
"3993",3993,130,608,971,749,"0007",49,44,5
"3994",3994,250,855,1600,1123,"0009",141,85,56
"3995",3995,190,929,1612,1134,"0001",739,543,196
"3996",3996,209,1337,2137,1576,"0002",676,494,182
"3997",3997,562,1075,2554,1673,"0003",605,398,207
"3998",3998,849,1569,3872,2458,"0004",720,563,157
"3999",3999,55,274,478,331,"0001",1797,1271,526
"4000",4000,799,1635,3805,2487,"0002",5822,5156,666
"4001",4001,173,957,1567,1149,"0003",655,617,38
"4002",4002,394,2442,4032,2869,"0004",885,822,63
"4003",4003,199,1386,2134,1611,"0005",697,653,44
"4004",4004,146,790,1296,953,"0006",5933,5233,700
"4005",4005,112,495,917,627,"0007",837,790,47
"4006",4006,30,145,261,179,"0008",862,790,72
"4007",4007,488,508,1728,1021,"0009",3062,2407,655
"4008",4008,513,1200,2724,1744,"0010",2620,1391,1229
"4009",4009,529,2164,3633,2734,"0011",1269,1125,144
"4010",4010,611,2510,4279,3182,"0012",1089,970,119
"4011",4011,160,283,741,452,"0013",2978,2649,329
"4012",4012,312,1861,2985,2197,"0014",1328,1142,186
"4013",4013,46,50,247,97,"0015",2264,1886,378
"4014",4014,224,559,1104,797,"0016",2774,2427,347
"4015",4015,506,1142,2350,1678,"0017",1207,1110,97
"4016",4016,503,1252,2537,1790,"0018",5336,4773,563
"4017",4017,50,126,249,179,"0019",1217,1048,169
"4018",4018,284,777,1463,1076,"0001",3584,2004,1580
"4019",4019,374,795,1667,1187,"0002",2641,1540,1101
"4020",4020,820,1889,3797,2751,"0003",2242,1519,723
"4021",4021,425,997,2133,1447,"0004",2009,1416,593
"4022",4022,582,1920,3320,2541,"0005",1594,1170,424
"4023",4023,610,2100,3950,2759,"0006",6379,1945,4434
"4024",4024,304,1500,2426,1831,"0007",987,27,960
"4025",4025,434,1915,3380,2385,"0008",2456,1164,1292
"4026",4026,866,2254,4597,3165,"0009",3280,872,2408
"4027",4027,904,2051,4089,2997,"0010",2902,332,2570
"4028",4028,1013,1644,4851,2687,"0011",2784,275,2509
"4029",4029,736,2156,4354,2932,"0012",1259,291,968
"4030",4030,401,2866,4535,3316,"0013",5348,1979,3369
"4031",4031,444,1491,3238,1973,"0014",2012,1399,613
"4032",4032,479,2690,4463,3202,"0015",2941,2216,725
"4033",4033,267,596,1581,880,"0016",4642,2401,2241
"4034",4034,492,2328,4237,2863,"0017",1625,457,1168
"4035",4035,264,279,991,548,"0018",1481,821,660
"4036",4036,1156,1110,3228,2292,"0019",1998,952,1046
"4037",4037,1681,301,3704,2007,"0020",3801,1490,2311
"4038",4038,1144,415,3305,1588,"0021",1481,531,950
"4039",4039,1400,1196,4786,2631,"0022",4033,344,3689
"4040",4040,193,1036,1836,1238,"0023",2510,37,2473
"4041",4041,80,690,1034,781,"0024",1334,291,1043
"4042",4042,663,529,2061,1211,"0025",1620,133,1487
"4043",4043,159,816,1204,986,"0026",2894,642,2252
"4044",4044,268,866,1528,1141,"0027",4736,945,3791
"4045",4045,437,726,1836,1177,"0028",6748,2662,4086
"4046",4046,168,787,1475,968,"0029",4655,318,4337
"4047",4047,91,441,812,536,"0030",4904,2157,2747
"4048",4048,50,250,413,300,"0031",3304,85,3219
"4049",4049,152,1134,1684,1301,"0032",5032,2737,2295
"4050",4050,209,605,1128,826,"0033",5396,3447,1949
"4051",4051,185,759,1399,962,"0034",3945,2416,1529
"4052",4052,178,793,1430,988,"0035",20,4,16
"4053",4053,244,529,1135,784,"0036",6465,490,5975
"4054",4054,154,352,744,520,"0037",3295,2233,1062
"4055",4055,316,328,1092,661,"0038",3594,2488,1106
"4056",4056,502,1606,3182,2162,"0039",4375,2847,1528
"4057",4057,802,1575,3239,2438,"0040",515,424,91
"4058",4058,180,724,1219,915,"0041",1990,579,1411
"4059",4059,85,342,599,431,"0042",1042,12,1030
"4060",4060,74,104,236,181,"0043",3868,713,3155
"4061",4061,109,44,359,160,"0044",2980,472,2508
"4062",4062,248,569,1254,838,"0045",14616,1172,13444
"4063",4063,256,487,1083,760,"0046",3810,425,3385
"4064",4064,42,202,308,244,"0047",2261,104,2157
"4065",4065,487,1287,2568,1808,"0048",1282,126,1156
"4066",4066,421,857,1676,1314,"0049",9077,3725,5352
"4067",4067,348,1075,1921,1457,"0050",6135,1758,4377
"4068",4068,221,696,1235,935,"0051",2146,1396,750
"4069",4069,7,2,11,11,"0052",3832,2303,1529
"4070",4070,0,2,3,2,"0053",4053,2676,1377
"4071",4071,27,106,187,136,"0054",2151,1448,703
"4072",4072,3,12,32,15,"0055",4349,2540,1809
"4073",4073,1,11,18,13,"0056",1973,982,991
"4074",4074,825,1702,3317,2602,"0057",3714,2775,939
"4075",4075,695,1365,2817,2105,"0058",4279,2592,1687
"4076",4076,133,175,648,314,"0059",3226,2319,907
"4077",4077,422,213,1235,647,"0060",3674,2303,1371
"4078",4078,170,121,682,295,"0061",3380,286,3094
"4079",4079,493,426,1728,934,"0062",3414,97,3317
"4080",4080,245,674,1340,941,"0063",2985,1948,1037
"4081",4081,859,593,2845,1476,"0064",4292,243,4049
"4082",4082,357,237,1204,612,"0065",3957,172,3785
"4083",4083,689,2128,3807,2879,"0066",2117,94,2023
"4084",4084,263,146,1078,422,"0067",7582,387,7195
"4085",4085,245,299,834,558,"0068",4253,122,4131
"4086",4086,43,47,113,91,"0069",2540,106,2434
"4087",4087,64,50,192,115,"0070",5119,3622,1497
"4088",4088,650,1474,2934,2180,"0071",8479,4821,3658
"4089",4089,125,374,692,511,"0072",3505,319,3186
"4090",4090,232,511,955,750,"0073",2576,1259,1317
"4091",4091,11,43,72,54,"0074",3531,2512,1019
"4092",4092,52,50,189,102,"0075",2327,1504,823
"4093",4093,22,23,84,47,"0076",3386,810,2576
"4094",4094,25,40,102,68,"0077",51,2,49
"4095",4095,31,23,85,54,"0078",2505,244,2261
"4096",4096,4,16,33,21,"0079",4618,134,4484
"4097",4097,1,1,8,2,"0080",4348,452,3896
"4098",4098,93,89,274,186,"0081",3979,385,3594
"4099",4099,60,27,179,88,"0082",4013,2315,1698
"4100",4100,9,4,20,13,"0083",6987,1527,5460
"4101",4101,80,137,382,221,"0084",1958,1118,840
"4102",4102,137,352,685,503,"0085",3893,957,2936
"4103",4103,194,374,766,582,"0086",5689,3358,2331
"4104",4104,49,50,161,100,"0087",2752,2077,675
"4105",4105,15,31,66,47,"0088",1475,931,544
"4106",4106,30,73,123,108,"0089",1431,956,475
"4107",4107,10,28,41,40,"0090",4352,3201,1151
"4108",4108,404,666,1461,1085,"0091",3417,1903,1514
"4109",4109,1205,1790,4148,3063,"0092",2291,1693,598
"4110",4110,1402,1764,4408,3228,"0093",6808,671,6137
"4111",4111,1232,1787,4116,3079,"0094",1358,71,1287
"4112",4112,1562,1877,4858,3518,"0095",5101,2551,2550
"4113",4113,602,1011,2248,1655,"0096",4120,205,3915
"4114",4114,1206,1561,3840,2829,"0097",6869,4409,2460
"4115",4115,545,753,2067,1332,"0098",4225,3204,1021
"4116",4116,802,1091,3155,1935,"0099",4146,985,3161
"4117",4117,404,1072,2059,1510,"0100",3056,705,2351
"4118",4118,1195,1417,3734,2677,"0101",2509,166,2343
"4119",4119,335,1256,2269,1623,"0102",3246,427,2819
"4120",4120,153,812,1239,979,"0103",9392,2479,6913
"4121",4121,269,1119,1993,1406,"0104",2194,33,2161
"4122",4122,445,887,1820,1359,"0105",4454,275,4179
"4123",4123,1056,900,2714,1995,"0106",681,114,567
"4124",4124,22,90,155,113,"0107",4026,229,3797
"4125",4125,1242,1061,3179,2342,"0108",7131,1728,5403
"4126",4126,96,507,770,614,"0109",3705,98,3607
"4127",4127,1214,1490,3870,2757,"0110",4035,1521,2514
"4128",4128,1554,1836,5107,3464,"0111",7295,4086,3209
"4129",4129,49,184,495,235,"0112",3604,1914,1690
"4130",4130,16,50,185,69,"0113",3639,1151,2488
"4131",4131,108,129,702,240,"0114",6394,3914,2480
"4132",4132,108,170,756,283,"0115",2913,131,2782
"4133",4133,49,99,327,158,"0116",3027,2352,675
"4134",4134,14,42,111,57,"0117",4696,603,4093
"4135",4135,32,239,417,271,"0118",5215,1827,3388
"4136",4136,107,319,1053,431,"0119",7603,3886,3717
"4137",4137,53,383,657,441,"0120",7639,2792,4847
"4138",4138,69,75,473,148,"0121",1920,668,1252
"4139",4139,106,139,847,253,"0122",2168,73,2095
"4140",4140,127,243,960,379,"0123",2310,1240,1070
"4141",4141,55,61,430,123,"0124",6343,4355,1988
"4142",4142,10,22,119,33,"0125",3695,1379,2316
"4143",4143,30,116,376,148,"0126",4656,3239,1417
"4144",4144,123,339,855,476,"0127",3521,2361,1160
"4145",4145,53,162,424,220,"0128",2315,1561,754
"4146",4146,140,419,958,569,"0129",8001,4170,3831
"4147",4147,131,623,1177,767,"0130",2569,1754,815
"4148",4148,21,23,94,44,"0131",5122,430,4692
"4149",4149,44,101,315,148,"0132",2234,31,2203
"4150",4150,144,550,1280,712,"0133",2661,1881,780
"4151",4151,12,85,179,98,"0134",2757,454,2303
"4152",4152,118,639,1221,770,"0135",4458,3025,1433
"4153",4153,117,182,964,306,"0136",2283,277,2006
"4154",4154,177,731,1303,924,"0137",3822,1729,2093
"4155",4155,101,392,794,509,"0138",2152,56,2096
"4156",4156,135,307,925,454,"0139",5274,3482,1792
"4157",4157,12,118,212,130,"0140",4528,1431,3097
"4158",4158,18,235,364,255,"0141",2401,573,1828
"4159",4159,50,195,446,247,"0142",1641,60,1581
"4160",4160,8,58,105,66,"0143",6858,2612,4246
"4161",4161,34,229,419,264,"0144",1217,27,1190
"4162",4162,11,56,133,69,"0145",1698,25,1673
"4163",4163,35,172,321,208,"0146",2364,1341,1023
"4164",4164,17,184,313,202,"0147",4279,322,3957
"4165",4165,13,101,191,114,"0148",2877,1786,1091
"4166",4166,106,616,1017,742,"0149",12661,5029,7632
"4167",4167,25,92,148,129,"0150",2089,34,2055
"4168",4168,19,100,124,130,"0151",1204,28,1176
"4169",4169,185,886,1530,1093,"0152",5922,472,5450
"4170",4170,22,127,180,162,"0153",3973,238,3735
"4171",4171,10,159,202,176,"0154",3658,174,3484
"4172",4172,17,129,186,152,"0155",5614,2674,2940
"4173",4173,7,130,211,144,"0156",4025,288,3737
"4174",4174,18,121,169,150,"0157",3184,115,3069
"4175",4175,128,642,1054,796,"0158",3319,31,3288
"4176",4176,102,608,1001,726,"0159",1805,388,1417
"4177",4177,34,432,765,470,"0160",930,42,888
"4178",4178,0,21,41,21,"0161",1393,77,1316
"4179",4179,12,181,254,198,"0162",3182,205,2977
"4180",4180,32,409,619,445,"0163",5181,550,4631
"4181",4181,29,296,522,336,"0164",1784,57,1727
"4182",4182,46,382,660,436,"0165",3985,1612,2373
"4183",4183,1,38,38,39,"0166",1639,863,776
"4184",4184,12,89,107,102,"0167",25,4,21
"4185",4185,64,350,635,418,"0168",751,22,729
"4186",4186,51,282,564,334,"0169",2701,45,2656
"4187",4187,60,328,649,391,"0170",4176,1050,3126
"4188",4188,66,370,634,437,"0171",2682,78,2604
"4189",4189,291,776,1695,1077,"0172",1160,110,1050
"4190",4190,366,2871,4844,3282,"0173",5528,3302,2226
"4191",4191,17,450,664,473,"0174",3577,2401,1176
"4192",4192,42,593,889,637,"0175",2753,1810,943
"4193",4193,24,437,680,463,"0176",1299,787,512
"4194",4194,308,2953,4737,3304,"0177",2967,1809,1158
"4195",4195,32,542,815,577,"0178",2473,1723,750
"4196",4196,69,594,887,670,"0179A",3145,1071,2074
"4197",4197,349,1414,2770,1783,"0179B",6,3,3
"4198",4198,547,533,2011,1091,"0180",3556,113,3443
"4199",4199,120,999,1702,1131,"0181",3834,288,3546
"4200",4200,121,904,1470,1035,"0182",4694,2494,2200
"4201",4201,187,1789,2784,2004,"0183",2380,1846,534
"4202",4202,91,947,1358,1043,"0184",2152,274,1878
"4203",4203,150,1288,2113,1453,"0185",3223,302,2921
"4204",4204,162,1612,2610,1793,"0186",1226,14,1212
"4205",4205,68,832,1156,909,"0187",693,23,670
"4206",4206,420,3310,5111,3772,"0188",3496,359,3137
"4207",4207,110,1014,1564,1138,"0189",1616,1139,477
"4208",4208,876,344,1578,1249,"0190",3856,364,3492
"4209",4209,1931,783,3709,2784,"0191",4664,449,4215
"4210",4210,1746,761,3052,2554,"0192",2951,166,2785
"4211",4211,1187,454,1892,1676,"0193",1248,155,1093
"4212",4212,971,375,1744,1372,"0194",3335,1635,1700
"4213",4213,1708,1258,4801,3008,"0195",2145,349,1796
"4214",4214,491,34,950,528,"0196",507,47,460
"4215",4215,705,510,1749,1240,"0197",3138,47,3091
"4216",4216,1169,342,2503,1547,"0198",719,49,670
"4217",4217,792,250,1976,1057,"0199",4599,3018,1581
"4218",4218,817,242,1944,1076,"0200",5183,3629,1554
"4219",4219,219,202,831,424,"0201",1067,27,1040
"4220",4220,681,1122,2988,1823,"0202",1941,86,1855
"4221",4221,963,584,1991,1576,"0203",1825,147,1678
"4222",4222,1574,999,3108,2628,"0204",4581,2919,1662
"4223",4223,1141,634,2493,1806,"0205",1988,43,1945
"4224",4224,524,318,1237,850,"0206",4166,1545,2621
"4225",4225,762,428,1506,1202,"0207",1367,440,927
"4226",4226,964,292,1751,1294,"0208",3580,346,3234
"4227",4227,1305,371,3141,1705,"0209",0,0,0
"4228",4228,772,149,1386,943,"0210",3781,1058,2723
"4229",4229,1304,218,2629,1538,"0211",6440,500,5940
"4230",4230,206,55,573,266,"0212",2207,90,2117
"4231",4231,513,81,965,599,"0213",3132,2541,591
"4232",4232,441,31,1072,477,"0214",1935,1161,774
"4233",4233,1071,310,2180,1402,"0215",2567,1544,1023
"4234",4234,1690,496,3630,2223,"0216",2874,94,2780
"4235",4235,1259,1292,3938,2585,"0217",2871,2116,755
"4236",4236,730,571,2952,1316,"0218",4848,756,4092
"4237",4237,1868,608,3752,2532,"0219",3267,476,2791
"4238",4238,1377,81,2932,1474,"0220",5877,1642,4235
"4239",4239,2190,727,4454,2984,"0221",4612,542,4070
"4240",4240,2454,847,4651,3377,"0222",3132,2424,708
"4241",4241,1959,421,3404,2411,"0223",7846,2138,5708
"4242",4242,183,66,325,252,"0224",3639,1797,1842
"4243",4243,1152,548,3140,1714,"0225",7175,2066,5109
"4244",4244,1657,506,2928,2203,"0226",4940,175,4765
"4245",4245,1930,627,3348,2586,"0227",1625,1385,240
"4246",4246,2167,534,3871,2737,"0228",1284,124,1160
"4247",4247,296,145,563,451,"0229",1632,142,1490
"4248",4248,709,426,1743,1150,"0230",1445,32,1413
"4249",4249,436,27,941,470,"0231",4818,368,4450
"4250",4250,787,518,2133,1317,"0232",1919,1231,688
"4251",4251,913,286,2281,1214,"0233",8743,5084,3659
"4252",4252,1257,370,2700,1646,"0234",5282,3850,1432
"4253",4253,0,0,0,0,"0235",1891,74,1817
"4254",4254,1081,301,2784,1403,"0236",2626,29,2597
"4255",4255,730,70,1629,805,"0237",2348,31,2317
"4256",4256,513,63,1030,583,"0238",2247,25,2222
"4257",4257,707,1127,2752,1868,"0239",2050,33,2017
"4258",4258,1769,1419,4772,3224,"0240",3145,65,3080
"4259",4259,351,906,1863,1279,"0241",5590,635,4955
"4260",4260,1569,773,3150,2382,"0242",4191,716,3475
"4261",4261,1302,558,2332,1896,"0243",565,3,562
"4262",4262,975,569,1902,1570,"0244",4795,1340,3455
"4263",4263,1549,733,3070,2343,"0245",6567,2893,3674
"4264",4264,608,598,1650,1231,"0246",5699,2278,3421
"4265",4265,2016,778,3593,2847,"0247",2723,364,2359
"4266",4266,1291,678,2588,2023,"0248",3931,440,3491
"4267",4267,1608,723,3015,2375,"0249",4749,2017,2732
"4268",4268,1903,413,3153,2348,"0250",1116,38,1078
"4269",4269,645,354,1888,1008,"0251",3626,376,3250
"4270",4270,784,352,2263,1152,"0252",2218,39,2179
"4271",4271,275,1023,2015,1312,"0253",2467,62,2405
"4272",4272,871,299,2401,1180,"0254",4126,207,3919
"4273",4273,750,304,2336,1068,"0255",2863,1606,1257
"4274",4274,412,159,1237,580,"0256",5864,1030,4834
"4275",4275,1211,414,3326,1642,"0257",8004,566,7438
"4276",4276,1861,89,3525,1968,"0258",3390,2555,835
"4277",4277,498,148,1377,650,"0259",2392,31,2361
"4278",4278,1819,1480,4273,3353,"0260",2213,533,1680
"4279",4279,1643,1073,3547,2785,"0261",3695,317,3378
"4280",4280,911,427,2241,1364,"0262",9877,2566,7311
"4281",4281,865,634,2015,1530,"0263",4779,2614,2165
"4282",4282,936,1956,3605,2937,"0264",6388,1463,4925
"4283",4283,1141,571,2256,1754,"0265",4874,3051,1823
"4284",4284,659,606,2019,1274,"0266",4134,682,3452
"4285",4285,0,0,0,0,"0267",2568,364,2204
"4286",4286,661,319,1791,987,"0268",2318,1516,802
"4287",4287,1026,445,3140,1489,"0269",2612,2002,610
"4288",4288,1260,461,2807,1733,"0270",6009,2112,3897
"4289",4289,740,531,2256,1283,"0271",2737,18,2719
"4290",4290,961,1658,3702,2657,"0272",5285,1414,3871
"4291",4291,1187,620,2891,1839,"0273",2280,1694,586
"4292",4292,275,669,1527,963,"0274",2982,1879,1103
"4293",4293,996,59,2176,1065,"0275",3422,193,3229
"4294",4294,2061,1124,4204,3265,"0276",2371,28,2343
"4295",4295,1352,1063,2970,2474,"0277",4468,590,3878
"4296",4296,481,1112,2288,1621,"0278",4803,671,4132
"4297",4297,648,423,1330,1092,"0279",3932,1237,2695
"4298",4298,596,1243,2438,1870,"0280",3173,290,2883
"4299",4299,666,818,2204,1517,"0281",2127,1493,634
"4300",4300,839,1012,2366,1879,"0282",4232,1507,2725
"4301",4301,1161,704,3988,1889,"0283",14658,698,13960
"4302",4302,224,77,615,307,"0284",10513,1523,8990
"4303",4303,1457,1348,3826,2834,"0285",3904,121,3783
"4304",4304,1235,340,2684,1597,"0286",5264,167,5097
"4305",4305,545,1543,2906,2121,"0287",1975,1210,765
"4306",4306,421,1817,3319,2258,"0288",1939,33,1906
"4307",4307,573,502,2381,1091,"0289",2743,340,2403
"4308",4308,479,415,1937,908,"0290",2842,1502,1340
"4309",4309,269,104,956,375,"0291",1776,662,1114
"4310",4310,571,276,1992,866,"0292",2340,80,2260
"4311",4311,873,801,2626,1689,"0293",2264,997,1267
"4312",4312,1066,78,1873,1149,"0294",1906,22,1884
"4313",4313,875,439,2543,1325,"0295",1061,24,1037
"4314",4314,68,55,280,123,"0296",2425,593,1832
"4315",4315,841,284,2416,1130,"0297",5375,596,4779
"4316",4316,1148,1010,3916,2201,"0298",3429,1399,2030
"4317",4317,1239,70,2537,1311,"0299",4318,602,3716
"4318",4318,1282,1235,3557,2557,"0300",5667,4010,1657
"4319",4319,904,1570,3273,2513,"0301",4461,646,3815
"4320",4320,1009,1373,3430,2429,"0302",5274,1328,3946
"4321",4321,1089,880,2907,1985,"0303",3965,3011,954
"4322",4322,630,1329,2630,1991,"0304",2650,1479,1171
"4323",4323,776,159,1868,947,"0305",8941,1346,7595
"4324",4324,992,1723,3261,2743,"0306",1718,1250,468
"4325",4325,705,381,2042,1101,"0307",4360,2907,1453
"4326",4326,983,655,2192,1665,"0308",3226,269,2957
"4327",4327,331,720,1430,1065,"0309",4029,3012,1017
"4328",4328,874,849,2426,1754,"0310",2218,1098,1120
"4329",4329,298,486,1218,793,"0311",6254,761,5493
"4330",4330,961,89,1902,1055,"0312",8615,3047,5568
"4331",4331,966,237,1891,1221,"0313",84,10,74
"4332",4332,731,1810,3306,2584,"0314",6923,2848,4075
"4333",4333,953,889,2811,1876,"0315",1852,1128,724
"4334",4334,689,2669,4258,3394,"0316",1587,1001,586
"4335",4335,427,1002,2381,1452,"0317",3022,569,2453
"4336",4336,1136,885,2498,2052,"0318",4620,171,4449
"4337",4337,974,894,2581,1885,"0319",2814,80,2734
"4338",4338,711,1129,2310,1862,"0320",3395,458,2937
"4339",4339,529,151,1188,686,"0321",5359,420,4939
"4340",4340,1302,55,2337,1372,"0322",2959,376,2583
"4341",4341,1393,979,2800,2397,"0323",4115,999,3116
"4342",4342,637,444,1726,1091,"0324",2809,1932,877
"4343",4343,1353,1447,3598,2844,"0325",4187,377,3810
"4344",4344,1287,93,2137,1393,"0326",1502,171,1331
"4345",4345,745,1172,2794,1936,"0327",1966,56,1910
"4346",4346,804,64,1659,874,"0328",4078,397,3681
"4347",4347,2137,1086,4346,3270,"0329",3295,370,2925
"4348",4348,2073,346,3516,2446,"0330",5992,1341,4651
"4349",4349,42,67,242,111,"0331",9000,2882,6118
"4350",4350,340,157,1022,499,"0332",5791,183,5608
"4351",4351,1444,1589,3751,3066,"0333",4512,3198,1314
"4352",4352,526,28,1035,558,"0334",1681,305,1376
"4353",4353,755,29,1513,792,"0335",7525,434,7091
"4354",4354,1074,563,2129,1660,"0336",9168,710,8458
"4355",4355,1646,285,3386,1962,"0337",2358,142,2216
"4356",4356,1543,590,2704,2156,"0338",8376,685,7691
"4357",4357,1201,1194,3087,2429,"0339",3197,298,2899
"4358",4358,798,58,1569,863,"0340",4501,3032,1469
"4359",4359,372,51,828,425,"0341",2495,151,2344
"4360",4360,1056,441,3293,1521,"0342",2161,215,1946
"4361",4361,692,340,2117,1036,"0343",4043,294,3749
"4362",4362,938,367,2467,1315,"0344",1482,33,1449
"4363",4363,1532,1864,4500,3437,"0345",6613,691,5922
"4364",4364,22,7,37,29,"0346",1,0,1
"4365",4365,1176,106,2384,1294,"0347",5783,1721,4062
"4366",4366,1497,56,2929,1569,"0348",3555,1462,2093
"4367",4367,633,143,1343,786,"0349",2496,1157,1339
"4368",4368,357,22,709,383,"0350",5977,2619,3358
"4369",4369,577,44,1129,628,"0351",5152,3627,1525
"4370",4370,463,298,1604,768,"0352",6590,3434,3156
"4371",4371,1002,705,3253,1724,"0353",6777,358,6419
"4372",4372,704,54,1442,764,"0354",6130,696,5434
"4373",4373,861,963,2635,1850,"0355",2352,173,2179
"4374",4374,767,301,1480,1088,"0356",5133,2180,2953
"4375",4375,24,5,67,29,"0357",4040,2747,1293
"4376",4376,233,14,498,248,"0358",7083,242,6841
"4377",4377,1253,73,2579,1344,"0359",9869,356,9513
"4378",4378,543,558,2199,1118,"0360",5001,2941,2060
"4379",4379,646,85,1579,737,"0361",2831,977,1854
"4380",4380,292,128,708,421,"0362",6071,3576,2495
"4381",4381,633,1375,2556,2036,"0363",9374,2230,7144
"4382",4382,1326,1642,3896,3033,"0364",5206,1189,4017
"4383",4383,1373,823,2710,2226,"0365",1204,201,1003
"4384",4384,655,464,1402,1128,"0366",7254,369,6885
"4385",4385,973,586,2140,1579,"0367",2183,492,1691
"4386",4386,848,859,2117,1723,"0368",1496,176,1320
"4387",4387,831,614,2192,1471,"0369",1043,257,786
"4388",4388,1274,101,2815,1402,"0370",5786,3440,2346
"4389",4389,868,393,2446,1279,"0371",642,9,633
"4390",4390,585,351,1207,950,"0372",1708,93,1615
"4391",4391,1154,1021,2668,2219,"0373",252,8,244
"4392",4392,441,180,1206,629,"0374",992,60,932
"4393",4393,870,420,2249,1301,"0375",8203,938,7265
"4394",4394,355,76,859,437,"0376",4226,699,3527
"4395",4395,100,43,324,146,"0377",3787,2725,1062
"4396",4396,526,357,1875,896,"0378",2264,1322,942
"4397",4397,740,564,1672,1326,"0379",2458,78,2380
"4398",4398,588,374,2073,980,"0380",6360,2375,3985
"4399",4399,417,263,1592,687,"0381",8767,1260,7507
"4400",4400,1017,119,2061,1149,"0382",2174,668,1506
"4401",4401,595,32,1113,636,"0383",4041,596,3445
"4402",4402,1557,375,2607,1964,"0384",3593,641,2952
"4403",4403,975,166,1968,1158,"0385",2137,1654,483
"4404",4404,224,41,440,271,"0386",4185,2242,1943
"4405",4405,1431,99,2960,1539,"0387",7398,3319,4079
"4406",4406,300,32,681,340,"0388",7531,2286,5245
"4407",4407,732,1702,3433,2469,"0389",4131,1326,2805
"4408",4408,2146,1166,4333,3380,"0390",5551,1604,3947
"4409",4409,338,32,828,373,"0391",3130,2017,1113
"4410",4410,671,49,1429,730,"0392",1369,17,1352
"4411",4411,380,116,1029,504,"0393",2711,1096,1615
"4412",4412,1675,1331,3889,3060,"0394",2235,346,1889
"4413",4413,929,73,1750,1014,"0395",1935,1370,565
"4414",4414,1706,629,3575,2382,"0396",2056,24,2032
"4415",4415,621,247,1237,883,"0397",1580,186,1394
"4416",4416,875,495,2408,1385,"0398",6447,1533,4914
"4417",4417,1830,549,3937,2409,"0399",7170,1130,6040
"4418",4418,1805,283,3309,2121,"0400",4599,1915,2684
"4419",4419,1087,723,3319,1843,"0401",2702,59,2643
"4420",4420,488,204,1491,700,"0402",2880,107,2773
"4421",4421,924,2048,3543,3008,"0403",1668,1279,389
"4422",4422,934,698,2037,1655,"0404",5252,1071,4181
"4423",4423,1144,852,2442,2019,"0405",4176,2663,1513
"4424",4424,1030,113,2036,1155,"0406",719,10,709
"4425",4425,1200,1105,2847,2342,"0407",5694,2277,3417
"4426",4426,1340,476,2793,1839,"0408",3788,347,3441
"4427",4427,1628,134,3043,1780,"0409",3838,332,3506
"4428",4428,446,816,2465,1276,"0410",1456,147,1309
"4429",4429,1029,663,2933,1709,"0411",4796,427,4369
"4430",4430,1586,809,3058,2436,"0412",688,58,630
"4431",4431,2180,479,4283,2707,"0413",3878,817,3061
"4432",4432,1419,699,2784,2145,"0414",6200,2667,3533
"4433",4433,497,263,1298,773,"0415",2602,1963,639
"4434",4434,975,377,2723,1370,"0416",7000,3216,3784
"4435",4435,647,797,1779,1481,"0417",3862,762,3100
"4436",4436,788,58,1229,855,"0418",7289,866,6423
"4437",4437,271,164,909,442,"0419",4606,1305,3301
"4438",4438,471,52,1094,526,"0420",5641,3805,1836
"4439",4439,916,406,2584,1333,"0421",2677,885,1792
"4440",4440,918,660,1947,1612,"0422",3987,43,3944
"4441",4441,1736,831,3505,2615,"0423",5245,209,5036
"4442",4442,1529,2140,4576,3690,"0424",1856,795,1061
"4443",4443,2058,137,3895,2220,"0425",1781,203,1578
"4444",4444,920,82,2014,1014,"0426",1971,400,1571
"4445",4445,1020,56,2146,1087,"0427",2416,266,2150
"4446",4446,875,65,1946,943,"0428",8706,545,8161
"4447",4447,931,62,1922,1007,"0429",6763,439,6324
"4448",4448,1329,78,2670,1423,"0430",5879,583,5296
"4449",4449,784,482,2772,1280,"0431",15519,975,14544
"4450",4450,501,458,2008,973,"0432",6840,795,6045
"4451",4451,363,12,541,384,"0433",1195,237,958
"4452",4452,1294,984,3505,2305,"0434",2226,1334,892
"4453",4453,993,1393,3607,2430,"0435",4596,3153,1443
"4454",4454,1644,1763,4828,3448,"0436",6080,3426,2654
"4455",4455,746,47,1719,800,"0437",3194,1847,1347
"4456",4456,604,323,2279,947,"0438",4124,2754,1370
"4457",4457,675,1085,3123,1786,"0439",5789,3089,2700
"4458",4458,736,258,1850,1003,"0440",2820,2076,744
"4459",4459,1210,218,2427,1448,"0441",1744,1182,562
"4460",4460,1179,53,2199,1238,"0442",4407,3319,1088
"4461",4461,1016,82,2136,1107,"0443",613,468,145
"4462",4462,394,177,1311,579,"0444",5535,1919,3616
"4463",4463,1314,669,2545,2013,"0445",3797,1314,2483
"4464",4464,1383,736,3519,2158,"0446",826,100,726
"4465",4465,1400,549,3864,1971,"0447",7204,3469,3735
"4466",4466,1083,1740,3438,2860,"0448",3441,2388,1053
"4467",4467,1364,66,2196,1439,"0449",314,6,308
"4468",4468,610,523,1581,1141,"0450",5780,795,4985
"4469",4469,496,279,1665,781,"0451",3099,2239,860
"4470",4470,1605,1407,4772,3051,"0452",7526,3695,3831
"4471",4471,1221,2083,4413,3351,"0453",4197,527,3670
"4472",4472,918,740,2743,1677,"0454",2653,46,2607
"4473",4473,1210,1776,3831,3017,"0455",2186,40,2146
"4474",4474,924,600,2867,1541,"0456",7281,2584,4697
"4475",4475,478,344,1580,831,"0457",0,0,0
"4476",4476,1214,847,2554,2094,"0458",3081,134,2947
"4477",4477,753,1191,2327,1963,"0459",3712,2876,836
"4478",4478,1506,1238,4143,2790,"0460",6869,627,6242
"4479",4479,1644,55,2712,1706,"0461",6247,3244,3003
"4480",4480,1035,427,2522,1485,"0462",4606,1182,3424
"4481",4481,691,1414,2564,2139,"0463",7780,1714,6066
"4482",4482,850,1003,2437,1886,"0464",3471,1600,1871
"4483",4483,718,197,1814,930,"0465",5385,1451,3934
"4484",4484,1250,48,2412,1307,"0466",5729,1725,4004
"4485",4485,616,414,2066,1045,"0467",1989,102,1887
"4486",4486,922,787,2912,1727,"0468",7647,487,7160
"4487",4487,407,608,1699,1029,"0469",3425,2506,919
"4488",4488,591,282,1756,880,"0470",1973,1038,935
"4489",4489,1206,690,2324,1911,"0471",3326,1890,1436
"4490",4490,930,749,2490,1712,"0472",1398,791,607
"4491",4491,1146,288,2522,1450,"0473",1887,1352,535
"4492",4492,1467,813,4026,2310,"0474",3877,2302,1575
"4493",4493,1431,212,2911,1651,"0475",3225,618,2607
"4494",4494,2201,323,3974,2541,"0476",2989,814,2175
"4495",4495,856,541,1775,1419,"0477",6400,3101,3299
"4496",4496,1192,47,2163,1245,"0478",7202,3139,4063
"4497",4497,548,389,1720,952,"0479",4233,2692,1541
"4498",4498,245,650,1280,902,"0480",3920,1896,2024
"4499",4499,551,304,1215,869,"0481",5288,2974,2314
"4500",4500,694,152,1545,852,"0482",5759,2918,2841
"4501",4501,700,346,1446,1061,"0483",7156,3127,4029
"4502",4502,1077,47,2004,1131,"0484",5873,2661,3212
"4503",4503,416,19,869,441,"0485",5705,3175,2530
"4504",4504,577,563,1695,1156,"0486",4998,3135,1863
"4505",4505,803,457,2179,1278,"0487",8570,448,8122
"4506",4506,920,698,2412,1652,"0488",3738,394,3344
"4507",4507,638,301,1786,953,"0489",2717,553,2164
"4508",4508,825,1622,3016,2478,"0490",2974,754,2220
"4509",4509,720,564,2558,1295,"0491",5079,2553,2526
"4510",4510,919,1049,3567,1987,"0492",4311,1457,2854
"4511",4511,1029,1946,3654,3002,"0493",4783,741,4042
"4512",4512,1013,815,2374,1858,"0494",5335,196,5139
"4513",4513,1813,904,4386,2756,"0495",3104,1466,1638
"4514",4514,669,879,1921,1560,"0496",3591,451,3140
"4515",4515,1003,1433,3333,2472,"0497",3149,155,2994
"4516",4516,661,253,1688,923,"0498",4881,1050,3831
"4517",4517,1266,1955,3873,3266,"0499",2566,1801,765
"4518",4518,502,604,1502,1118,"0500",5153,2417,2736
"4519",4519,941,862,3169,1822,"0501",2546,1748,798
"4520",4520,1442,1111,3926,2586,"0502",4497,2471,2026
"4521",4521,19,29,81,48,"0503",3010,1878,1132
"4522",4522,823,880,2304,1728,"0504",2442,1709,733
"4523",4523,719,623,1713,1356,"0505",7328,2402,4926
"4524",4524,731,498,1558,1248,"0506",4574,384,4190
"4525",4525,722,190,1626,922,"0507",12391,239,12152
"4526",4526,2187,217,3820,2428,"0508",8627,492,8135
"4527",4527,1196,148,2259,1353,"0509",8721,3882,4839
"4528",4528,493,372,1655,872,"0510",6554,2124,4430
"4529",4529,651,319,2015,977,"0511",11111,4328,6783
"4530",4530,409,165,1172,587,"0512",8009,1660,6349
"4531",4531,816,414,2094,1247,"0513",3305,2049,1256
"4532",4532,1084,1097,2720,2223,"0514",5836,2956,2880
"4533",4533,956,305,2344,1270,"0515",3106,2272,834
"4534",4534,289,199,848,497,"0516",3972,1091,2881
"4535",4535,855,86,1755,948,"0517",6952,1438,5514
"4536",4536,527,289,1713,831,"0518",5683,2185,3498
"4537",4537,657,347,1743,1019,"0519",4233,2071,2162
"4538",4538,1106,723,2828,1861,"0520",9328,787,8541
"4539",4539,1135,1042,2902,2208,"0521",4130,1177,2953
"4540",4540,1998,426,3727,2455,"0522",3189,2099,1090
"4541",4541,944,1817,3911,2800,"0523",5747,2055,3692
"4542",4542,421,85,1025,508,"0524",5450,752,4698
"4543",4543,651,258,1911,917,"0525",4210,787,3423
"4544",4544,3037,426,5048,3493,"0526",1826,131,1695
"4545",4545,541,109,1185,654,"0527",1175,161,1014
"4546",4546,1646,1084,4743,2760,"0528",122,2,120
"4547",4547,910,289,2213,1218,"0529",5324,3855,1469
"4548",4548,866,1631,3494,2547,"0530",1971,73,1898
"4549",4549,545,214,1504,767,"0531",3275,1860,1415
"4550",4550,436,140,1120,581,"0532",1727,725,1002
"4551",4551,929,372,2388,1317,"0533",2082,587,1495
"4552",4552,586,54,1259,644,"0534",5322,2351,2971
"4553",4553,947,246,2189,1203,"0535",676,87,589
"4554",4554,0,0,0,0,"0536",9110,758,8352
"4555",4555,1118,1362,3941,2508,"0537",3783,2238,1545
"4556",4556,469,738,1970,1223,"0538",1545,59,1486
"4557",4557,404,537,1527,963,"0539",2449,826,1623
"4558",4558,1853,609,3700,2508,"0540",3748,2097,1651
"4559",4559,813,1873,3528,2725,"0541",10199,1335,8864
"4560",4560,974,2281,4882,3305,"0542",3819,42,3777
"4561",4561,1961,599,4246,2586,"0543",3018,242,2776
"4562",4562,1604,602,3552,2225,"0544",448,25,423
"4563",4563,1159,137,1965,1305,"0545",5836,1135,4701
"4564",4564,1388,1096,3533,2535,"0546",2232,1906,326
"4565",4565,925,1842,3853,2797,"0547",3318,1886,1432
"4566",4566,799,139,1904,951,"0548",3894,952,2942
"4567",4567,1252,260,3412,1523,"0549",4158,158,4000
"4568",4568,1905,1042,3978,2988,"0550",5538,1193,4345
"4569",4569,1066,88,2111,1173,"0551",5448,3593,1855
"4570",4570,1506,2406,5290,3971,"0552",4216,3172,1044
"4571",4571,1779,856,4101,2665,"0553",4840,907,3933
"4572",4572,715,542,1961,1278,"0554",4248,338,3910
"4573",4573,902,135,1338,1047,"0555",4961,271,4690
"4574",4574,1653,716,4088,2397,"0556",4840,277,4563
"4575",4575,700,231,1503,938,"0557",4698,272,4426
"4576",4576,456,201,1114,664,"0558",7326,1420,5906
"4577",4577,253,54,976,310,"0559",10593,1697,8896
"4578",4578,739,1323,2778,2090,"0560",1939,64,1875
"4579",4579,261,17,496,279,"0561",4523,2089,2434
"4580",4580,675,120,1294,798,"0562",1040,29,1011
"4581",4581,64,7,156,73,"0563",4037,2799,1238
"4582",4582,248,139,734,392,"0564",7164,1923,5241
"4583",4583,856,596,3206,1466,"0565",5789,133,5656
"4584",4584,525,353,1512,884,"0566",6440,1112,5328
"4585",4585,128,334,663,468,"0567",8371,865,7506
"4586",4586,747,951,2530,1742,"0568",3790,2311,1479
"4587",4587,1083,156,2193,1256,"0569",7904,3646,4258
"4588",4588,2011,1538,4665,3600,"0570",3387,1510,1877
"4589",4589,826,574,2452,1418,"0571",3968,256,3712
"4590",4590,332,501,1309,841,"0572",6301,2382,3919
"4591",4591,912,524,2656,1457,"0573",2065,37,2028
"4592",4592,1337,501,2830,1854,"0574",562,12,550
"4593",4593,656,1138,2191,1812,"0575",6206,2180,4026
"4594",4594,360,770,1619,1143,"0576",3077,180,2897
"4595",4595,1005,2094,4986,3132,"0577",2418,1191,1227
"4596",4596,1261,913,3066,2206,"0578",1949,1410,539
"4597",4597,549,56,1340,614,"0579",3086,180,2906
"4598",4598,974,128,1605,1112,"0580",1187,67,1120
"4599",4599,508,526,1471,1049,"0581",1045,19,1026
"4600",4600,769,29,1390,806,"0582",2326,70,2256
"4601",4601,520,379,1520,925,"0583",1701,42,1659
"4602",4602,250,203,1069,461,"0584",1535,38,1497
"4603",4603,602,824,1961,1454,"0585",3412,83,3329
"4604",4604,1225,79,2082,1314,"0586",6207,2271,3936
"4605",4605,268,153,903,424,"0587",4981,813,4168
"4606",4606,1587,1183,4353,2810,"0588",5034,2354,2680
"4607",4607,1471,685,4085,2183,"0589",7327,2094,5233
"4608",4608,3,4,10,7,"0590",2053,1608,445
"4609",4609,947,95,2072,1053,"0591",4145,277,3868
"4610",4610,1676,162,2857,1852,"0592",3062,147,2915
"4611",4611,862,603,1780,1485,"0593",6908,1077,5831
"4612",4612,837,807,2972,1662,"0594",3728,614,3114
"4613",4613,952,2256,4061,3247,"0595",3875,247,3628
"4614",4614,281,13,585,298,"0596",5580,1649,3931
"4615",4615,1471,1538,4343,3058,"0597",6305,780,5525
"4616",4616,458,270,1526,734,"0598",8835,1522,7313
"4617",4617,612,352,1985,975,"0599",5627,1019,4608
"4618",4618,431,126,973,563,"0600",6379,1104,5275
"4619",4619,817,416,2567,1244,"0601",4158,2750,1408
"4620",4620,216,18,469,237,"0602",1744,881,863
"4621",4621,1357,839,3199,2224,"0603",7216,2798,4418
"4622",4622,573,1269,2851,1857,"0604",4340,3319,1021
"4623",4623,705,1057,2360,1795,"0605",6439,529,5910
"4624",4624,1281,961,3560,2294,"0606",1191,11,1180
"4625",4625,384,280,1071,669,"0607",1931,57,1874
"4626",4626,1452,875,4247,2357,"0608",1597,97,1500
"4627",4627,833,989,2996,1850,"0609",6082,2032,4050
"4628",4628,769,3071,5115,3873,"0610",6557,772,5785
"4629",4629,1101,777,2482,1895,"0611",2946,34,2912
"4630",4630,1932,119,3482,2073,"0612",3382,2587,795
"4631",4631,500,206,1512,715,"0613",4206,255,3951
"4632",4632,498,398,1283,907,"0614",7035,844,6191
"4633",4633,404,153,1151,562,"0615",2916,915,2001
"4634",4634,428,401,1325,835,"0616",4042,2219,1823
"4635",4635,524,317,1458,846,"0617",6309,1078,5231
"4636",4636,1012,727,2843,1753,"0618",6528,1632,4896
"4637",4637,1196,497,3262,1709,"0619",5256,3404,1852
"4638",4638,734,218,1827,961,"0620",5972,2165,3807
"4639",4639,1696,537,4347,2270,"0621",2414,680,1734
"4640",4640,602,243,1718,854,"0622",6446,1874,4572
"4641",4641,242,77,592,322,"0623",6193,2546,3647
"4642",4642,701,594,1736,1314,"0624",1570,828,742
"4643",4643,1384,1400,3585,2823,"0625",2449,1232,1217
"4644",4644,1780,1407,4350,3230,"0626",6987,2974,4013
"4645",4645,849,990,2381,1869,"0627",6338,540,5798
"4646",4646,1275,1738,3877,3055,"0628",4281,456,3825
"4647",4647,1472,1776,4298,3288,"0629",1574,74,1500
"4648",4648,903,1612,3048,2550,"0630",7331,424,6907
"4649",4649,498,813,1669,1334,"0631",3980,1820,2160
"4650",4650,991,2517,4551,3562,"0632",25,6,19
"4651",4651,228,331,688,567,"0633",4218,2448,1770
"4652",4652,1159,1094,3302,2293,"0634",4528,1646,2882
"4653",4653,771,807,2336,1600,"0635",4062,2775,1287
"4654",4654,96,55,354,153,"0636",5758,4604,1154
"4655",4655,1328,1502,3559,2867,"0637",3629,583,3046
"4656",4656,1454,1154,3429,2645,"0638",3531,99,3432
"4657",4657,2,0,5,2,"0639",3134,1930,1204
"4658",4658,1183,434,2936,1639,"0640",5332,1954,3378
"4659",4659,652,1567,2886,2236,"0641",5314,1901,3413
"4660",4660,810,1226,3032,2068,"0642",2048,1406,642
"4661",4661,389,148,881,539,"0643",6444,1603,4841
"4662",4662,1269,62,2460,1338,"0644",6607,2729,3878
"4663",4663,734,70,1628,816,"0645",10277,3040,7237
"4664",4664,1222,1268,4468,2540,"0646",3598,332,3266
"4665",4665,0,0,0,0,"0647",9721,364,9357
"4666",4666,1185,120,2131,1321,"0648",3726,2081,1645
"4667",4667,1014,2077,4039,3135,"0649",7893,606,7287
"4668",4668,1968,759,4182,2751,"0650",5062,2476,2586
"4669",4669,1667,1791,4584,3491,"0651",5499,1786,3713
"4670",4670,1273,642,2782,1941,"0652",3480,157,3323
"4671",4671,1077,563,2536,1662,"0653",2526,100,2426
"4672",4672,815,986,2717,1835,"0654",6755,1663,5092
"4673",4673,1622,917,4106,2582,"0655",5993,2760,3233
"4674",4674,1692,1411,4440,3132,"0656",3088,65,3023
"4675",4675,597,246,1433,852,"0657",2502,471,2031
"4676",4676,1862,871,4559,2754,"0658",3466,1580,1886
"4677",4677,742,1796,3382,2568,"0659",6755,3844,2911
"4678",4678,272,672,1483,957,"0660",4713,166,4547
"4679",4679,437,1373,2692,1840,"0661",7758,2241,5517
"4680",4680,638,271,1179,924,"0662",4344,2886,1458
"4681",4681,584,810,1819,1421,"0663",2987,1737,1250
"4682",4682,296,411,1021,720,"0664",5810,322,5488
"4683",4683,422,354,1231,783,"0665",3260,2015,1245
"4684",4684,439,386,1279,837,"0666",0,0,0
"4685",4685,1306,2008,4734,3369,"0667",2442,1436,1006
"4686",4686,1154,1263,3696,2457,"0668",6477,2870,3607
"4687",4687,1052,1979,4070,3080,"0669",4621,2388,2233
"4688",4688,817,1229,2939,2075,"0670",3130,2525,605
"4689",4689,932,1881,4062,2854,"0671",4351,1573,2778
"4690",4690,1214,1761,4326,3028,"0672",5292,2427,2865
"4691",4691,2064,1438,5120,3564,"0673",3423,2421,1002
"4692",4692,1341,1643,4200,3031,"0674",5193,3192,2001
"4693",4693,1164,2113,4659,3316,"0675",0,0,0
"4694",4694,1104,2428,4582,3587,"0676",5007,840,4167
"4695",4695,1402,954,4323,2375,"0677",3057,206,2851
"4696",4696,814,406,2007,1232,"0678",3748,209,3539
"4697",4697,999,346,2046,1365,"0679",5661,2474,3187
"4698",4698,1053,451,2245,1523,"0680",253,171,82
"4699",4699,1125,742,2788,1894,"0681",253,140,113
"4700",4700,1009,726,2667,1751,"0682",5424,3260,2164
"4701",4701,1467,954,3712,2443,"0683",674,59,615
"4702",4702,1468,357,3357,1847,"0684",5690,2175,3515
"4703",4703,883,1244,2701,2147,"0685",328,219,109
"4704",4704,935,576,2557,1526,"0686",698,119,579
"4705",4705,577,45,1106,631,"0687",2988,1369,1619
"4706",4706,636,286,1510,938,"0688",4860,3318,1542
"4707",4707,837,1182,2527,2043,"0689",3635,594,3041
"4708",4708,1249,1574,4182,2857,"0690",4915,3023,1892
"4709",4709,1330,535,2436,1900,"0691",5043,2972,2071
"4710",4710,384,1525,3028,1934,"0692",4396,3018,1378
"4711",4711,727,1413,2805,2172,"0693",1012,206,806
"4712",4712,905,999,2413,1934,"0694",4367,1020,3347
"4713",4713,1759,1015,4391,2838,"0695",3531,1293,2238
"4714",4714,2025,457,3692,2499,"0696",4064,1493,2571
"4715",4715,683,421,2680,1119,"0697",5185,491,4694
"4716",4716,1693,1174,5037,2893,"0698",4654,132,4522
"4717",4717,760,943,2601,1749,"0699",2435,1403,1032
"4718",4718,1825,933,4162,2804,"0700",2299,1481,818
"4719",4719,1096,1271,2993,2392,"0701",1292,177,1115
"4720",4720,1928,1243,5177,3223,"0702",927,12,915
"4721",4721,925,1447,3163,2401,"0703",1941,1452,489
"4722",4722,1258,1956,4684,3261,"0704",3770,2464,1306
"4723",4723,788,1735,3306,2559,"0705",2402,107,2295
"4724",4724,960,842,2730,1821,"0706",5156,1426,3730
"4725",4725,1074,800,3033,1899,"0707",1120,567,553
"4726",4726,1505,1578,4377,3121,"0708",1261,115,1146
"4727",4727,851,1224,3268,2118,"0709",5672,2241,3431
"4728",4728,189,24,479,214,"0710",2958,2040,918
"4729",4729,1253,901,3279,2184,"0711",7835,2601,5234
"4730",4730,933,1648,3431,2610,"0712",7052,1385,5667
"4731",4731,1253,1274,3938,2576,"0713",3246,950,2296
"4732",4732,1625,757,3764,2405,"0714",733,73,660
"4733",4733,1727,519,3412,2261,"0715",2658,702,1956
"4734",4734,329,133,907,471,"0716",3433,2058,1375
"4735",4735,138,115,646,255,"0717",3090,124,2966
"4736",4736,686,206,1471,899,"0718",5437,3059,2378
"4737",4737,649,2287,4172,2991,"0719",2987,769,2218
"4738",4738,417,180,1294,607,"0720",7763,3604,4159
"4739",4739,439,1287,2493,1735,"0721",2955,1989,966
"4740",4740,239,433,1132,680,"0722",7139,159,6980
"4741",4741,291,313,1229,609,"0723",2933,256,2677
"4742",4742,340,757,1638,1111,"0724",1334,583,751
"4743",4743,114,98,425,215,"0725",3937,668,3269
"4744",4744,1449,1060,3957,2531,"0726",2430,1843,587
"4745",4745,868,1809,3349,2695,"0727",5164,947,4217
"4746",4746,1209,62,2445,1284,"0728",1466,652,814
"4747",4747,681,598,1851,1297,"0729",549,186,363
"4748",4748,1574,467,2758,2067,"0730",3106,2000,1106
"4749",4749,1171,188,2198,1375,"0731",8179,2005,6174
"4750",4750,1534,181,2860,1726,"0732",2779,1323,1456
"4751",4751,645,316,1798,978,"0733",1277,79,1198
"4752",4752,121,17,291,140,"0734",5782,2768,3014
"4753",4753,784,732,2089,1527,"0735",1123,561,562
"4754",4754,524,1512,2549,2059,"0736",38,0,38
"4755",4755,679,1107,2627,1823,"0737",61,21,40
"4756",4756,898,659,2563,1592,"0738",3504,194,3310
"4757",4757,1464,322,2994,1806,"0739",5067,1240,3827
"4758",4758,1218,627,3411,1868,"0740",2017,495,1522
"4759",4759,764,1414,2745,2203,"0741",3411,283,3128
"4760",4760,846,2414,4247,3307,"0742",4332,2242,2090
"4761",4761,1225,789,3055,2035,"0743",537,65,472
"4762",4762,788,241,1844,1037,"0744",2416,1353,1063
"4763",4763,854,246,2136,1106,"0745",3542,1907,1635
"4764",4764,1025,424,2676,1465,"0746",1462,649,813
"4765",4765,1040,739,3185,1799,"0747",6900,1757,5143
"4766",4766,641,305,1554,958,"0748",3478,1367,2111
"4767",4767,2438,662,5454,3132,"0749",952,60,892
"4768",4768,402,159,1218,562,"0750",2077,596,1481
"4769",4769,770,1227,3405,2037,"0751",13589,5378,8211
"4770",4770,317,59,702,382,"0752",2440,946,1494
"4771",4771,852,1690,3529,2566,"0753",578,136,442
"4772",4772,2184,461,4084,2686,"0754",3414,112,3302
"4773",4773,423,170,1394,598,"0755",9900,1294,8606
"4774",4774,1368,490,3133,1888,"0756",2507,455,2052
"4775",4775,1198,483,3119,1695,"0757",10917,779,10138
"4776",4776,1319,1502,3701,2859,"0758",4761,3296,1465
"4777",4777,2159,1325,5043,3532,"0759",3597,1374,2223
"4778",4778,853,296,1714,1166,"0760",1865,1545,320
"4779",4779,472,277,1742,760,"0761",1723,1273,450
"4780",4780,1549,790,3677,2368,"0762",4280,837,3443
"4781",4781,806,31,1661,846,"0763",2134,165,1969
"4782",4782,154,38,413,193,"0764",6039,2669,3370
"4783",4783,1638,1518,4708,3198,"0765",9685,1426,8259
"4784",4784,1554,169,3022,1743,"0766",871,52,819
"4785",4785,776,817,2030,1623,"0767",204,40,164
"4786",4786,786,782,1959,1590,"0768",2776,1949,827
"4787",4787,458,142,1336,602,"0769",213,14,199
"4788",4788,479,39,970,525,"0770",1259,173,1086
"4789",4789,553,27,975,584,"0771",3954,680,3274
"4790",4790,774,90,1714,869,"0772",4681,3202,1479
"4791",4791,608,40,1285,650,"0773",6433,350,6083
"4792",4792,1601,142,3237,1754,"0774",1255,251,1004
"4793",4793,1088,132,2454,1234,"0775",124,4,120
"4794",4794,1060,1061,3549,2153,"0776",4196,1739,2457
"4795",4795,1594,663,3557,2282,"0777",2487,165,2322
"4796",4796,1326,1664,4250,3038,"0778",0,0,0
"4797",4797,960,643,2658,1620,"0779",2931,178,2753
"4798",4798,552,1162,2210,1739,"0780",1500,150,1350
"4799",4799,801,395,2445,1216,"0781",6449,473,5976
"4800",4800,979,393,2392,1391,"0782",2526,1320,1206
"4801",4801,1634,1444,4860,3114,"0783",1638,47,1591
"4802",4802,885,286,1917,1187,"0784",1050,26,1024
"4803",4803,882,213,2042,1109,"0785",7342,2223,5119
"4804",4804,1354,919,3954,2316,"0786",2863,317,2546
"4805",4805,1068,629,2910,1720,"0787",982,87,895
"4806",4806,1324,685,3147,2041,"0788",19,2,17
"4807",4807,290,120,645,415,"0789",4294,1730,2564
"4808",4808,1878,1030,4578,2940,"0790",4317,713,3604
"4809",4809,1155,2087,4318,3292,"0791",45,6,39
"4810",4810,449,760,1608,1224,"0792",2881,162,2719
"4811",4811,1193,1194,3485,2416,"0793",5923,1307,4616
"4812",4812,446,2195,3622,2681,"0794",8296,400,7896
"4813",4813,853,357,2068,1227,"0795",2311,186,2125
"4814",4814,458,22,914,482,"0796",4563,1133,3430
"4815",4815,464,76,1054,544,"0797",0,0,0
"4816",4816,422,250,1409,683,"0798",689,203,486
"4817",4817,1308,1569,4135,2908,"0799",290,25,265
"4818",4818,840,583,2520,1439,"0800",5448,2383,3065
"4819",4819,1193,94,2491,1301,"0801",608,44,564
"4820",4820,830,1760,3517,2637,"0802",26,17,9
"4821",4821,1195,361,2576,1571,"0803",4876,2753,2123
"4822",4822,1819,811,4190,2651,"0804",8781,2741,6040
"4823",4823,961,764,2471,1746,"0805",2902,2222,680
"4824",4824,1102,1391,3379,2543,"0806",3896,1693,2203
"4825",4825,1934,930,4673,2897,"0807",4996,589,4407
"4826",4826,1722,1109,4438,2883,"0808",1044,545,499
"4827",4827,1494,2381,5136,3949,"0809",275,51,224
"4828",4828,1527,1145,3878,2704,"0810",438,27,411
"4829",4829,589,391,1543,990,"0811",414,15,399
"4830",4830,1673,1709,4861,3426,"0812",0,0,0
"4831",4831,1488,1530,4515,3067,"0813",6432,1415,5017
"4832",4832,284,627,1169,926,"0814",8813,1108,7705
"4833",4833,1634,908,3946,2582,"0815",0,0,0
"4834",4834,1970,1500,5104,3531,"0816",98,14,84
"4835",4835,1230,617,3339,1864,"0817",6210,3457,2753
"4836",4836,892,558,2600,1471,"0818",1325,382,943
"4837",4837,155,16,406,173,"0819",157,93,64
"4838",4838,3266,357,5131,3650,"0820",0,0,0
"4839",4839,1009,1310,3296,2345,"0821",4573,146,4427
"4840",4840,12,18,46,31,"0822",1911,20,1891
"4841",4841,1318,1929,4237,3294,"0823",4364,1287,3077
"4842",4842,1113,1134,3594,2273,"0824",4750,386,4364
"4843",4843,815,1632,3582,2491,"0825",26,3,23
"4844",4844,211,1357,2109,1588,"0826",383,231,152
"4845",4845,1298,489,2915,1806,"0827",3358,261,3097
"4846",4846,1228,152,2482,1391,"0828",1919,1471,448
"4847",4847,499,1319,2671,1853,"0829",94,47,47
"4848",4848,1502,1688,4902,3244,"0830",97,41,56
"4849",4849,1231,1439,4050,2697,"0831",118,16,102
"4850",4850,435,963,1870,1423,"0832",1062,98,964
"4851",4851,1638,1298,4595,2970,"0833",24,0,24
"4852",4852,1654,1765,4921,3489,"0834",515,29,486
"4853",4853,1339,628,2956,1999,"0835",527,28,499
"4854",4854,1022,633,2584,1667,"0836",398,22,376
"4855",4855,1640,1246,5076,2905,"0837",302,142,160
"4856",4856,1106,1631,3758,2778,"0838",0,0,0
"4857",4857,2014,936,4995,2978,"0839",3102,625,2477
"4858",4858,1176,1619,3769,2834,"0840",2466,466,2000
"4859",4859,1192,1090,3491,2318,"0841",5378,651,4727
"4860",4860,1671,426,3122,2111,"0842",5473,1029,4444
"4861",4861,263,89,691,356,"0843",1970,179,1791
"4862",4862,965,981,2844,1970,"0844",9,0,9
"4863",4863,1449,1418,4205,2913,"0845",750,392,358
"4864",4864,272,22,551,295,"0846",366,35,331
"4865",4865,970,531,2298,1529,"0847",4733,507,4226
"4866",4866,922,1240,3306,2209,"0848",2299,433,1866
"4867",4867,775,1367,3002,2167,"0849",3639,298,3341
"4868",4868,2026,353,3487,2399,"0850",224,52,172
"4869",4869,1245,999,3418,2285,"0851",5766,2760,3006
"4870",4870,413,1250,2169,1682,"0852",0,0,0
"4871",4871,299,189,635,496,"0853",2949,1942,1007
"4872",4872,1106,422,3103,1551,"0854",300,4,296
"4873",4873,470,1587,2815,2083,"0855",104,0,104
"4874",4874,0,0,0,0,"0856",0,0,0
"4875",4875,615,1012,2221,1654,"0857",0,0,0
"4876",4876,1449,1592,4601,3102,"0858",432,12,420
"4877",4877,1175,1574,3728,2786,"0859",1286,132,1154
"4878",4878,772,1867,3417,2684,"0860",0,0,0
"4879",4879,1236,1078,3547,2362,"0861",3368,173,3195
"4880",4880,1065,1671,4063,2782,"0862",4685,1867,2818
"4881",4881,479,1688,3022,2201,"0863",700,32,668
"4882",4882,1259,2284,4698,3574,"0864",4753,220,4533
"4883",4883,704,1157,2810,1891,"0865",15,0,15
"4884",4884,0,0,0,0,"0866",0,0,0
"4885",4885,1171,756,3290,1955,"0867",0,0,0
"4886",4886,524,208,1444,743,"0868",4350,347,4003
"4887",4887,1359,184,2756,1554,"0869",1437,63,1374
"4888",4888,316,562,1272,890,"0870",0,0,0
"4889",4889,121,24,214,148,"0871",1,0,1
"4890",4890,71,30,148,106,"0872",144,25,119
"4891",4891,696,1613,3260,2339,"0873",1148,110,1038
"4892",4892,110,52,344,163,"0874",3466,2246,1220
"4893",4893,1434,1804,4578,3276,"0875",5860,1781,4079
"4894",4894,96,82,297,178,"0876",5769,2919,2850
"4895",4895,75,27,227,103,"0877",9063,1706,7357
"4896",4896,945,1327,2942,2305,"0878",2075,1317,758
"4897",4897,1049,2499,4418,3605,"0879",4308,1018,3290
"4898",4898,945,789,2678,1760,"0880",3285,1883,1402
"4899",4899,1112,2095,4288,3250,"0881",14394,1792,12602
"4900",4900,1082,2402,4486,3533,"0882",7004,959,6045
"4901",4901,832,1651,3713,2518,"0883",9657,614,9043
"4902",4902,386,119,754,507,"0884",1257,69,1188
"4903",4903,575,333,1488,923,"0885",3607,1506,2101
"4904",4904,426,671,2047,1121,"0886",1466,704,762
"4905",4905,536,784,2476,1348,"0887",726,477,249
"4906",4906,1251,532,2959,1806,"0888",3245,570,2675
"4907",4907,748,151,1546,912,"0889",326,148,178
"4908",4908,848,1000,2420,1876,"0890",3206,1967,1239
"4909",4909,278,1488,2538,1782,"0891",2502,1177,1325
"4910",4910,193,161,719,362,"0892",2286,873,1413
"4911",4911,293,59,675,355,"0893",12,6,6
"4912",4912,768,1314,2724,2124,"0894",5009,423,4586
"4913",4913,580,1928,3378,2543,"0895",894,705,189
"4914",4914,434,72,1307,510,"0896",2269,1531,738
"4915",4915,1357,753,3253,2134,"0897",3053,1097,1956
"4916",4916,298,323,913,629,"0898",3135,656,2479
"4917",4917,189,112,655,307,"0899",1581,760,821
"4918",4918,1776,1680,4803,3505,"0900",21,6,15
"4919",4919,1298,953,2864,2286,"0901",0,0,0
"4920",4920,2084,1393,4778,3512,"0902",4114,2614,1500
"4921",4921,1915,1070,4789,3038,"0903",3692,2017,1675
"4922",4922,820,616,2158,1452,"0904",0,0,0
"4923",4923,126,90,464,220,"0905",1468,221,1247
"4924",4924,314,238,956,557,"0906",23,19,4
"4925",4925,592,1289,2839,1918,"0907",347,66,281
"4926",4926,1094,231,2186,1339,"0908",0,0,0
"4927",4927,1245,1569,3607,2857,"0909",43,3,40
"4928",4928,454,499,1773,968,"0910",424,53,371
"4929",4929,719,958,2430,1709,"0911",1199,494,705
"4930",4930,1089,1195,3012,2317,"0912",2127,714,1413
"4931",4931,2459,245,4743,2729,"0913",511,29,482
"4932",4932,1482,458,3078,1964,"0914",247,50,197
"4933",4933,462,520,1191,996,"0915",7,1,6
"4934",4934,843,538,2393,1393,"0916",4779,2969,1810
"4935",4935,232,1195,1880,1442,"0917",115,6,109
"4936",4936,455,130,1070,595,"0918",38,14,24
"4937",4937,292,295,960,604,"0919",0,0,0
"4938",4938,207,97,409,312,"0920",94,61,33
"4939",4939,935,1123,2677,2091,"0921",81,0,81
"4940",4940,1347,870,3685,2260,"0923",4449,2614,1835
"4941",4941,700,777,2079,1512,"0924",0,0,0
"4942",4942,110,53,376,164,"0925",0,0,0
"4943",4943,815,1150,2694,1985,"0926",1881,782,1099
"4944",4944,912,1264,3189,2212,"0927",2012,1285,727
"4945",4945,973,506,1934,1510,"0928",7,0,7
"4946",4946,9,15,42,24,"0929",0,0,0
"4947",4947,267,48,665,317,"0930",1006,17,989
"4948",4948,763,554,2500,1336,"0931",133,82,51
"4949",4949,63,70,261,133,"0932",0,0,0
"4950",4950,947,497,2351,1456,"0933",1053,283,770
"4951",4951,522,699,1597,1240,"0934",261,40,221
"4952",4952,74,41,258,117,"0935",75,12,63
"4953",4953,768,837,2203,1646,"0936",258,32,226
"4954",4954,897,967,2728,1900,"0937",0,0,0
"4955",4955,282,213,836,505,"0938",1453,55,1398
"4956",4956,1224,876,3404,2134,"0939",8,0,8
"4957",4957,598,407,1763,1029,"0940",39,0,39
"4958",4958,153,51,491,210,"0941",1884,876,1008
"4959",4959,270,257,929,535,"0942",155,104,51
"4960",4960,918,1052,2995,2006,"0943",2081,70,2011
"4961",4961,367,653,1611,1036,"0944",6,2,4
"4962",4962,243,126,535,375,"0945",25,0,25
"4963",4963,614,56,1599,684,"0946",34,2,32
"4964",4964,1125,747,3165,1891,"0947",885,593,292
"4965",4965,812,380,1925,1212,"0948",0,0,0
"4966",4966,1677,382,3507,2082,"0949",221,102,119
"4967",4967,1133,2461,4728,3650,"0950",4,0,4
"4968",4968,839,860,2422,1726,"0951",607,76,531
"4969",4969,597,1462,2636,2085,"0952",57,45,12
"4970",4970,560,904,1753,1493,"0953",11,5,6
"4971",4971,725,601,1751,1335,"0954",0,0,0
"4972",4972,421,280,1340,715,"0955",10729,6250,4479
"4973",4973,834,927,2481,1789,"0956",18,12,6
"4974",4974,1211,507,3051,1739,"0957",794,56,738
"4975",4975,189,75,515,270,"0958",1941,106,1835
"4976",4976,25,29,98,54,"0959",10,5,5
"4977",4977,705,1428,2795,2156,"0960",2569,343,2226
"4978",4978,97,14,179,112,"0961",4553,130,4423
"4979",4979,139,70,492,210,"0962",8172,2021,6151
"4980",4980,563,365,1772,949,"0963",1561,249,1312
"4981",4981,1425,2227,4670,3700,"0964",6846,2467,4379
"4982",4982,1276,807,3252,2095,"0965",727,264,463
"4983",4983,278,83,574,366,"0966",4134,441,3693
"4984",4984,1606,1012,3415,2666,"0967",358,73,285
"4985",4985,1095,1095,3381,2229,"0968",3421,435,2986
"4986",4986,192,101,851,301,"0969",625,2,623
"4987",4987,138,129,428,271,"0970",3383,151,3232
"4988",4988,298,139,1138,442,"0971",0,0,0
"4989",4989,206,121,698,329,"0972",9,1,8
"4990",4990,1339,951,4046,2325,"0973",2164,845,1319
"4991",4991,744,960,2469,1736,"0974",0,0,0
"4992",4992,458,73,872,535,"0975",202,92,110
"4993",4993,520,26,1029,551,"0976",1752,345,1407
"4994",4994,1221,1080,3103,2340,"0977",2055,184,1871
"4995",4995,413,253,1448,670,"0978",0,0,0
"4996",4996,208,97,624,311,"0979",0,0,0
"4997",4997,189,96,452,287,"0980",1417,769,648
"4998",4998,1056,1085,3171,2170,"0981",76,7,69
"4999",4999,1505,825,3604,2362,"0982",7701,4441,3260
"5000",5000,0,0,0,0,"0983",444,182,262
"5001",5001,804,327,2048,1147,"0984",765,37,728
"5002",5002,785,806,2819,1611,"0985",434,216,218
"5003",5003,225,38,704,264,"0986",1364,46,1318
"5004",5004,433,249,1388,691,"0987",1501,48,1453
"5005",5005,1352,868,3410,2249,"0988",183,112,71
"5006",5006,0,0,0,0,"0989",0,0,0
"5007",5007,268,148,573,426,"0990",200,5,195
"5008",5008,587,292,1440,893,"0991",4,0,4
"5009",5009,1336,1536,4285,2919,"0992",1649,492,1157
"5010",5010,154,78,417,236,"0993",0,0,0
"5011",5011,0,0,0,0,"0994",373,102,271
"5012",5012,1495,2140,4782,3705,"0995",2811,223,2588
"5013",5013,2009,1622,5173,3676,"0996",831,317,514
"5014",5014,659,1564,2941,2251,"0997",3879,462,3417
"5015",5015,940,1317,3078,2299,"0998",124,53,71
"5016",5016,922,216,2173,1159,"0999",0,0,0
"5017",5017,2,2,9,4,"1000",843,29,814
"5018",5018,20,33,117,53,"1001",3006,176,2830
"5019",5019,52,25,189,77,"1002",6409,317,6092
"5020",5020,104,46,289,151,"1003",0,0,0
"5021",5021,1,0,1,1,"1004",916,485,431
"5022",5022,1812,1185,4504,3042,"1005",0,0,0
"5023",5023,1020,348,2305,1380,"1006",8,0,8
"5024",5024,0,0,0,0,"1007",3391,385,3006
"5025",5025,14,10,64,25,"1008",1510,1109,401
"5026",5026,615,1129,2345,1767,"1009",0,0,0
"5027",5027,260,94,732,358,"1010",2019,160,1859
"5028",5028,82,65,212,149,"1011",39,17,22
"5029",5029,480,449,1459,941,"1012",3199,145,3054
"5030",5030,466,117,1312,588,"0001",2424,1492,932
"5031",5031,772,69,1587,848,"0002",3461,1193,2268
"5032",5032,1084,1128,3326,2240,"0003",2855,573,2282
"5033",5033,1108,374,2565,1498,"0004",2529,1152,1377
"5034",5034,894,840,2724,1757,"0005",961,768,193
"5035",5035,202,106,392,314,"0006",1594,1248,346
"5036",5036,281,189,1161,476,"0007",969,703,266
"5037",5037,470,1126,2039,1626,"0008",2960,1908,1052
"5038",5038,34,28,116,63,"0009",1902,1277,625
"5039",5039,62,19,83,83,"0010",1140,783,357
"5040",5040,9,3,36,12,"0011",740,382,358
"5041",5041,149,58,403,209,"0012",5493,4455,1038
"5042",5042,3,2,10,5,"0013",1348,1122,226
"5043",5043,146,15,283,162,"0014",1534,1073,461
"5044",5044,126,69,365,198,"0015",1152,1062,90
"5045",5045,160,18,305,180,"0016",678,591,87
"5046",5046,50,24,92,76,"0017",1863,876,987
"5047",5047,0,0,0,0,"0018",788,636,152
"5048",5048,539,174,1259,724,"0019",4526,3309,1217
"5049",5049,806,432,1960,1256,"0020",3083,2063,1020
"5050",5050,1923,611,4094,2558,"0021",794,521,273
"5051",5051,992,649,2785,1661,"0022",2826,930,1896
"5052",5052,802,214,1552,1027,"0023",586,525,61
"5053",5053,854,1962,3671,2860,"0024",716,564,152
"5054",5054,88,130,264,218,"0025",4287,3504,783
"5055",5055,137,29,370,169,"0026",656,418,238
"5056",5056,1288,423,2740,1728,"0101",432,275,157
"5057",5057,939,376,1937,1332,"0102",200,149,51
"5058",5058,929,540,2501,1486,"0201",300,232,68
"5059",5059,108,55,214,164,"0202",621,506,115
"5060",5060,1293,1779,4430,3118,"0301",866,690,176
"5061",5061,635,1101,2294,1763,"0401",1803,848,955
"5062",5062,723,1360,2811,2118,"0001",397,311,86
"5063",5063,64,16,179,81,"0002",1309,788,521
"5064",5064,868,579,1935,1468,"0003",670,448,222
"5065",5065,0,0,0,0,"0004",341,225,116
"5066",5066,0,0,0,0,"0005",448,310,138
"5067",5067,195,9,373,206,"0006",386,282,104
"5068",5068,452,161,1008,619,"0007",144,102,42
"5069",5069,949,915,2627,1896,"0008",176,141,35
"5070",5070,1018,218,2170,1250,"0009",279,257,22
"5071",5071,1455,1690,4207,3180,"0010",182,141,41
"5072",5072,287,30,576,319,"0110",2778,1146,1632
"5073",5073,1048,425,2906,1494,"0111",345,233,112
"5074",5074,1206,1110,3210,2346,"0112",3010,1029,1981
"5075",5075,0,0,0,0,"0113",1692,579,1113
"5076",5076,568,169,1273,741,"0114",2542,938,1604
"5077",5077,766,364,2050,1143,"0115",3099,1276,1823
"5078",5078,141,36,364,178,"0120",2284,834,1450
"5079",5079,0,0,0,0,"0121",3952,1601,2351
"5080",5080,21,4,46,25,"0122",2375,995,1380
"5081",5081,137,228,811,371,"0123",2378,714,1664
"5082",5082,388,170,880,569,"0125A",5153,1633,3520
"5083",5083,857,1642,3354,2522,"0125B",44,3,41
"5084",5084,1543,1284,3965,2860,"0126",4054,1660,2394
"5085",5085,746,1104,2388,1878,"0127",1369,451,918
"5086",5086,1095,580,2463,1704,"0128",4274,1553,2721
"5087",5087,403,857,1585,1272,"0129",3531,1402,2129
"5088",5088,1155,903,3188,2081,"0130",3730,1420,2310
"5089",5089,794,1506,3024,2327,"0220",3268,2146,1122
"5090",5090,1363,494,2924,1879,"0221",3855,1973,1882
"5091",5091,1566,862,3568,2451,"0222",2515,1403,1112
"5092",5092,1346,361,2948,1728,"0223",3377,1290,2087
"5093",5093,183,51,433,237,"0224",2299,1479,820
"5094",5094,1225,1256,3389,2511,"0225",1450,1011,439
"5095",5095,455,258,1002,726,"0226",2682,1993,689
"5096",5096,236,133,567,383,"0227A",4119,1647,2472
"5097",5097,1139,482,2533,1638,"0227B",0,0,0
"5098",5098,115,26,216,146,"0228A",5101,2054,3047
"5099",5099,867,481,2321,1377,"0228B",2,0,2
"5100",5100,703,334,1403,1052,"0228C",0,0,0
"5101",5101,782,223,1537,1022,"0229",5885,764,5121
"5102",5102,618,681,1607,1314,"0230A",1577,1170,407
"5103",5103,1334,234,2790,1582,"0230B",0,0,0
"5104",5104,514,198,896,733,"0231",4894,1744,3150
"5105",5105,1018,388,1756,1424,"0232A",1758,1237,521
"5106",5106,869,679,2219,1567,"0232B",0,0,0
"5107",5107,927,506,2259,1468,"0232C",0,0,0
"5108",5108,522,557,1361,1092,"0233",1899,541,1358
"5109",5109,4,5,15,10,"0234",2448,595,1853
"5110",5110,1306,1315,3378,2662,"0235",3637,2470,1167
"5111",5111,1521,1082,3288,2643,"0236",1551,1192,359
"5112",5112,654,1475,2962,2158,"0238",210,113,97
"5113",5113,0,0,0,0,"0301",0,0,0
"5114",5114,315,267,1039,586,"0315",3527,2643,884
"5115",5115,1308,1304,3363,2644,"0316",2241,1210,1031
"5116",5116,110,14,234,125,"0317",600,306,294
"5117",5117,0,0,0,0,"0318",116,79,37
"5118",5118,620,1350,2500,1993,"0330",2263,1414,849
"5119",5119,69,49,279,119,"0332",4994,3074,1920
"5120",5120,142,212,625,361,"0333A",4231,3519,712
"5121",5121,535,544,1608,1091,"0333B",8,3,5
"5122",5122,143,45,277,190,"0333C",2,0,2
"5123",5123,43,24,148,68,"0334",5093,1312,3781
"5124",5124,700,1467,2898,2200,"0335A",3547,2888,659
"5125",5125,891,2109,3858,3049,"0335B",0,0,0
"5126",5126,0,0,0,0,"0335C",0,0,0
"5127",5127,4,1,5,5,"0335D",0,0,0
"5128",5128,1552,920,3175,2496,"0336",3430,2101,1329
"5129",5129,64,149,302,216,"0337",3009,2471,538
"5130",5130,61,145,291,209,"0338",2322,2050,272
"5131",5131,0,0,0,0,"0339A",1221,965,256
"5132",5132,1163,2228,4256,3441,"0339B",7,1,6
"5133",5133,0,0,0,0,"0339C",0,0,0
"5134",5134,0,0,0,0,"0339D",0,0,0
"5135",5135,830,1235,2982,2100,"0339E",0,0,0
"5136",5136,1836,1238,3993,3135,"0340",2811,1833,978
"5137",5137,23,21,56,45,"0413A",1848,376,1472
"5138",5138,0,0,0,0,"0413B",0,0,0
"5139",5139,271,57,637,331,"0414",3194,1198,1996
"5140",5140,59,39,129,102,"0415A",5411,2460,2951
"5141",5141,0,0,0,0,"0415B",0,0,0
"5142",5142,428,129,831,566,"0416",411,103,308
"5143",5143,32,11,104,46,"0417",2809,1423,1386
"5144",5144,1082,581,2831,1685,"0418",22,3,19
"5145",5145,40,16,104,56,"0419",2279,1201,1078
"5146",5146,1318,634,2659,1985,"0420A",1193,719,474
"5147",5147,102,30,290,135,"0420B",9,5,4
"5148",5148,0,0,0,0,"0420C",0,0,0
"5149",5149,13,0,26,13,"0421",72,54,18
"5150",5150,406,305,1146,731,"0440",2433,1981,452
"5151",5151,107,50,361,159,"0441",3286,2697,589
"5152",5152,213,115,724,332,"0442",3376,2643,733
"5153",5153,36,17,125,55,"0443",4007,3102,905
"5154",5154,30,14,100,44,"0444",2635,2194,441
"5155",5155,242,230,686,479,"0445",2279,1910,369
"5156",5156,424,242,850,682,"0446",2252,1757,495
"5157",5157,168,328,697,503,"0447",2835,1730,1105
"5158",5158,689,171,1355,864,"0448",1862,1544,318
"5159",5159,0,0,0,0,"0449A",4746,3692,1054
"5160",5160,165,65,366,234,"0449B",0,0,0
"5161",5161,204,166,616,378,"0449C",5,0,5
"5162",5162,153,225,630,383,"0101",553,334,219
"5163",5163,453,115,1000,576,"0201",622,410,212
"5164",5164,803,1234,2558,2062,"0202",42,24,18
"5165",5165,1077,278,2374,1369,"0301",531,432,99
"5166",5166,343,61,609,408,"0302",30,29,1
"5167",5167,850,216,1899,1074,"0303",98,80,18
"5168",5168,0,0,0,0,"0401",430,231,199
"5169",5169,1059,260,1918,1333,"0402",90,81,9
"5170",5170,813,235,1870,1058,"0002",1057,625,432
"5171",5171,59,7,173,69,"0003",2750,811,1939
"5172",5172,331,227,889,561,"0004",3738,2676,1062
"5173",5173,954,880,2339,1861,"001A",2572,2016,556
"5174",5174,65,128,371,193,"001M",2548,1714,834
"5175",5175,512,187,1451,707,"001T",1897,1587,310
"5176",5176,1003,254,2213,1272,"002E",2797,2463,334
"5177",5177,1477,338,2471,1837,"003B",3273,2683,590
"5178",5178,405,8,630,421,"003C",4412,3583,829
"5179",5179,346,47,942,399,"003M",1900,1543,357
"5180",5180,233,113,477,349,"003N",1978,1556,422
"5181",5181,791,1558,2904,2382,"004A",1965,1052,913
"5182",5182,419,456,1209,894,"004W",1159,937,222
"5183",5183,737,370,1791,1127,"01CR",3000,2432,568
"5184",5184,85,60,189,147,"01MN",1622,1366,256
"5185",5185,202,200,824,408,"01TC",3797,3263,534
"5186",5186,468,308,1436,784,"03WS",2261,1931,330
"5187",5187,63,74,187,138,"04BV",987,851,136
"5188",5188,0,0,0,0,"04CC",2006,1610,396
"5189",5189,409,695,1412,1114,"04MS",567,307,260
"5190",5190,18,13,47,31,"04PF",504,398,106
"5191",5191,752,1685,3062,2481,"04SE",3560,2922,638
"5192",5192,1387,1487,3882,2910,"2GBN",4404,3698,706
"5193",5193,104,15,255,119,"2GBS",2827,2416,411
"5194",5194,141,101,314,247,"2PSN",4411,3823,588
"5195",5195,254,68,665,324,"2PSS",1738,1523,215
"5196",5196,618,82,1245,703,"4NYL",1200,1023,177
"5197",5197,496,1477,2752,1998,"0001",1699,43,1656
"5198",5198,1,0,3,1,"0002",3183,413,2770
"5199",5199,16,23,73,39,"0003",1256,36,1220
"5200",5200,1156,1073,2971,2261,"0004",6011,303,5708
"5201",5201,386,315,1185,713,"0005",2538,33,2505
"5202",5202,0,0,0,0,"0006",4209,574,3635
"5203",5203,1403,245,2578,1664,"0007",4929,611,4318
"5204",5204,1249,146,2089,1406,"0008",2609,420,2189
"5205",5205,276,261,767,544,"0009",3606,251,3355
"5206",5206,766,116,2086,895,"0010",3467,197,3270
"5207",5207,5,0,7,5,"0011",2287,46,2241
"5208",5208,0,0,0,0,"0012",215,4,211
"5209",5209,179,46,441,226,"0013",6650,590,6060
"5210",5210,694,264,1757,966,"0014",1438,90,1348
"5211",5211,414,124,1163,544,"0015",1151,89,1062
"5212",5212,106,26,267,133,"0016",2165,56,2109
"5213",5213,336,237,775,589,"0017",2263,692,1571
"5214",5214,0,0,0,0,"0018",560,15,545
"5215",5215,872,125,1459,1011,"0019",221,37,184
"5216",5216,1007,320,2216,1344,"0020",1321,21,1300
"5217",5217,220,763,1338,993,"0021",700,15,685
"5218",5218,110,71,315,182,"0022",1073,33,1040
"5219",5219,615,180,1210,805,"0023",3056,517,2539
"5220",5220,16,10,44,26,"0024",121,46,75
"5221",5221,720,409,1910,1139,"0025",4567,694,3873
"5222",5222,0,0,0,0,"0026",1773,74,1699
"5223",5223,0,0,0,0,"0027",1510,52,1458
"5224",5224,0,0,0,0,"0028",4852,452,4400
"5225",5225,919,1792,3713,2743,"0029",1652,310,1342
"5226",5226,156,46,339,206,"0030",6966,385,6581
"5227",5227,0,0,0,0,"0031",2882,294,2588
"5228",5228,154,26,369,183,"0032",2857,157,2700
"5229",5229,648,312,1491,970,"0033",1959,89,1870
"5230",5230,412,302,1119,722,"0034",1195,67,1128
"5231",5231,655,1168,2463,1854,"0035",5067,297,4770
"5232",5232,300,204,868,510,"0036",4305,128,4177
"5233",5233,77,202,401,283,"0037",1577,134,1443
"5234",5234,349,263,806,620,"0038",4044,508,3536
"5235",5235,642,436,1903,1094,"0039",3313,68,3245
"5236",5236,126,270,566,400,"0040",4083,28,4055
"5237",5237,1450,1058,3532,2543,"0041",6707,111,6596
"5238",5238,969,1020,2712,2017,"0042",3884,270,3614
"5239",5239,115,63,383,180,"0043",8860,188,8672
"5240",5240,406,946,2254,1367,"0044",2495,54,2441
"5241",5241,107,81,300,193,"0045",1442,432,1010
"5242",5242,246,184,684,440,"0046",537,37,500
"5243",5243,592,442,1671,1049,"0047",2822,73,2749
"5244",5244,28,23,72,51,"0048",4972,102,4870
"5245",5245,16,14,44,31,"0049",4095,177,3918
"5246",5246,1011,720,2837,1742,"0050",3317,73,3244
"5247",5247,913,1029,2439,1965,"0051",2731,26,2705
"5248",5248,0,0,0,0,"0052",5248,611,4637
"5249",5249,581,222,1328,816,"0053",7689,355,7334
"5250",5250,425,206,921,638,"0054",2397,334,2063
"5251",5251,907,473,2128,1393,"0055",2925,142,2783
"5252",5252,669,927,2289,1620,"0056",3112,99,3013
"5253",5253,85,73,254,161,"0057",1552,36,1516
"5254",5254,276,232,812,515,"0058",5025,193,4832
"5255",5255,437,383,1274,834,"0059",3504,54,3450
"5256",5256,402,440,1287,857,"0060",5402,262,5140
"5257",5257,195,280,694,487,"0061",4325,148,4177
"5258",5258,198,98,492,302,"0062",4145,897,3248
"5259",5259,578,47,1097,627,"0063",1367,111,1256
"5260",5260,0,0,0,0,"0064",5640,56,5584
"5261",5261,0,0,0,0,"0065",1600,89,1511
"5262",5262,521,234,1240,769,"0066",1723,99,1624
"5263",5263,925,1145,3145,2116,"0067",2674,378,2296
"5264",5264,1151,1349,3165,2524,"0068",5214,304,4910
"5265",5265,1110,1283,3029,2419,"0069",12305,675,11630
"5266",5266,2,4,9,6,"0070",3505,73,3432
"5267",5267,104,90,295,197,"0071",285,17,268
"5268",5268,633,582,1856,1231,"0072",1555,120,1435
"5269",5269,1338,249,3116,1611,"0073",3361,623,2738
"5270",5270,1053,191,2440,1258,"0074",1542,148,1394
"5271",5271,530,1174,2552,1721,"0075",135,5,130
"5272",5272,950,695,2592,1658,"0076",61,12,49
"5273",5273,1060,1042,2890,2130,"0077",2692,323,2369
"5274",5274,740,1366,2657,2132,"0078",3245,95,3150
"5275",5275,5,1,13,6,"0079",2720,51,2669
"5276",5276,805,381,1945,1199,"0080",1704,12,1692
"5277",5277,1200,655,2971,1868,"0081",6122,511,5611
"5278",5278,0,0,0,0,"0082",10,1,9
"5279",5279,76,41,276,117,"0083",4241,659,3582
"5280",5280,1299,749,3236,2072,"0084",1699,96,1603
"5281",5281,633,423,1759,1070,"0085",4723,137,4586
"5282",5282,0,0,0,0,"0086",749,154,595
"5283",5283,431,255,1181,698,"0087",11731,267,11464
"5284",5284,0,0,0,0,"0088",8548,195,8353
"5285",5285,1382,717,3284,2132,"0089",24,9,15
"5286",5286,1406,596,3118,2023,"0090",3924,95,3829
"5287",5287,799,803,2349,1624,"0091",1443,62,1381
"5288",5288,1035,426,2487,1478,"0092",978,38,940
"5289",5289,384,378,1133,775,"0093",298,100,198
"5290",5290,114,31,241,146,"0094",4069,194,3875
"5291",5291,0,0,0,0,"0095",6096,102,5994
"5292",5292,0,0,0,0,"0096",3753,687,3066
"5293",5293,154,201,486,363,"0097",3946,264,3682
"5294",5294,231,1529,2372,1780,"0098",5008,222,4786
"5295",5295,1088,2334,4652,3472,"0099",12751,343,12408
"5296",5296,1193,557,2632,1778,"0100",3867,224,3643
"5297",5297,252,231,740,492,"0101",1234,183,1051
"5298",5298,2,1,6,3,"0102",1427,828,599
"5299",5299,180,182,528,367,"0103",3755,519,3236
"5300",5300,790,810,2340,1618,"0104",5780,186,5594
"5301",5301,376,301,1029,687,"0105",4669,291,4378
"5302",5302,379,1165,2020,1564,"0106",6217,656,5561
"5303",5303,0,0,0,0,"0107",3313,210,3103
"5304",5304,677,1211,2740,1916,"0108",3044,100,2944
"5305",5305,596,1386,2847,2017,"0109",6779,551,6228
"5306",5306,554,326,1438,896,"0110",2112,49,2063
"5307",5307,978,192,2005,1179,"0111",3221,472,2749
"5308",5308,2,1,6,3,"0112",1884,53,1831
"5309",5309,248,196,760,447,"0113",5617,434,5183
"5310",5310,543,689,1576,1248,"0114",4723,1086,3637
"5311",5311,954,1273,3222,2266,"0115",4488,137,4351
"5312",5312,649,416,1767,1085,"0116",3368,419,2949
"5313",5313,719,1021,2388,1760,"0117",7173,145,7028
"5314",5314,79,20,198,100,"0118",2543,127,2416
"5315",5315,433,110,1081,549,"0119",1551,25,1526
"5316",5316,62,45,202,107,"0120",3046,168,2878
"5317",5317,73,88,323,163,"0121",124,9,115
"5318",5318,24,33,75,58,"0122",4346,59,4287
"5319",5319,650,873,1991,1545,"0123",1215,142,1073
"5320",5320,727,838,2380,1595,"0124",2015,407,1608
"5321",5321,723,840,2361,1579,"0125",1953,69,1884
"5322",5322,1085,729,3064,1840,"0126",2224,533,1691
"5323",5323,1270,285,2654,1574,"0127",1378,28,1350
"5324",5324,201,204,573,408,"0128",3448,55,3393
"5325",5325,658,547,1592,1217,"0129",184,29,155
"5326",5326,977,1087,2894,2083,"0130",2170,218,1952
"5327",5327,1210,512,3065,1750,"0131",32,2,30
"5328",5328,3,0,8,3,"0132",1125,30,1095
"5329",5329,769,679,1952,1472,"0133",238,10,228
"5330",5330,140,24,443,166,"0134",3207,712,2495
"5331",5331,636,113,2035,764,"0135",2890,365,2525
"5332",5332,604,488,1558,1106,"0136",2002,263,1739
"5333",5333,0,0,0,0,"0137",47,13,34
"5334",5334,0,0,0,0,"0138",805,12,793
"5335",5335,942,320,2127,1274,"0139",895,63,832
"5336",5336,594,200,1342,803,"0140",64,13,51
"5337",5337,887,1607,3351,2529,"0141",136,21,115
"5338",5338,0,0,0,0,"0142",65,0,65
"5339",5339,261,171,736,436,"0143",39,0,39
"5340",5340,92,172,357,269,"0144",64,4,60
"5341",5341,0,0,0,0,"0145",1486,27,1459
"5342",5342,31,22,77,53,"0146",3689,47,3642
"5343",5343,894,1337,2880,2261,"0147",352,16,336
"5344",5344,1459,772,3280,2265,"0148",214,7,207
"5345",5345,1511,552,3255,2095,"0149",90,1,89
"5346",5346,1144,414,2459,1581,"0150",2880,330,2550
"5347",5347,667,362,1516,1039,"0151",904,35,869
"5348",5348,1464,390,3206,1877,"0152",2606,334,2272
"5349",5349,107,45,237,155,"0153",597,7,590
"5350",5350,0,0,0,0,"0154",4279,194,4085
"5351",5351,48,255,405,306,"0155",820,56,764
"5352",5352,0,0,0,0,"0156",2804,77,2727
"5353",5353,396,821,1623,1237,"0157",1829,38,1791
"5354",5354,978,1517,3140,2525,"0158",6953,227,6726
"5355",5355,768,1186,2463,1982,"0159",1085,24,1061
"5356",5356,38,9,68,47,"0160",750,270,480
"5357",5357,490,170,1142,667,"0161",2851,154,2697
"5358",5358,1303,1182,3171,2516,"0162",330,11,319
"5359",5359,0,0,0,0,"0163",305,24,281
"5360",5360,778,1733,3150,2552,"0164",2896,467,2429
"5361",5361,37,156,287,194,"0165",1024,88,936
"5362",5362,0,0,0,0,"0166",1004,97,907
"5363",5363,0,0,0,0,"0167",639,121,518
"5364",5364,2,0,5,2,"0168",307,95,212
"5365",5365,0,0,0,0,"0169",582,13,569
"5366",5366,0,0,0,0,"0170",1329,13,1316
"5367",5367,0,0,0,0,"0171",34,1,33
"5368",5368,0,0,0,0,"0172",52,0,52
"5369",5369,0,0,0,0,"0173",2822,522,2300
"5370",5370,0,0,0,0,"0174",1523,18,1505
"5371",5371,0,0,0,0,"0175",1705,78,1627
"5372",5372,0,0,0,0,"0176",2432,187,2245
"5373",5373,0,0,0,0,"0177",1431,86,1345
"5374",5374,0,0,0,0,"0178",36,11,25
"5375",5375,511,953,2185,1495,"0179",894,14,880
"5376",5376,700,379,2191,1100,"0180",530,11,519
"5377",5377,895,96,2775,1008,"0181",917,598,319
"5378",5378,307,476,1404,793,"0182",3645,68,3577
"5379",5379,135,551,1017,695,"0183",1280,20,1260
"5380",5380,190,959,1651,1164,"0184",66,25,41
"5381",5381,170,459,945,639,"0185",5,3,2
"5382",5382,523,1282,2585,1846,"0186",320,28,292
"5383",5383,221,833,1610,1071,"0187",4279,773,3506
"5384",5384,191,601,1086,801,"0188",3764,1018,2746
"5385",5385,134,213,558,352,"0189",4490,98,4392
"5386",5386,281,1657,2810,1971,"0190",721,175,546
"5387",5387,234,1548,2375,1806,"0191",595,18,577
"5388",5388,208,775,1494,999,"0192",855,48,807
"5389",5389,79,750,1177,839,"0193",777,38,739
"5390",5390,63,385,605,456,"0194",3106,899,2207
"5391",5391,486,578,1713,1080,"0195",1618,722,896
"5392",5392,323,984,1927,1328,"0196",1484,650,834
"5393",5393,400,1743,3267,2175,"0197",3734,42,3692
"5394",5394,362,1351,2819,1737,"0198",719,16,703
"5395",5395,147,378,782,538,"0199",3080,290,2790
"5396",5396,612,386,1874,1017,"0200",2510,325,2185
"5397",5397,30,411,558,447,"0201",1370,143,1227
"5398",5398,152,531,1043,695,"0202",1406,657,749
"5399",5399,294,1714,2820,2043,"0203",5629,500,5129
"5400",5400,252,1462,2505,1755,"0204",1187,166,1021
"5401",5401,20,207,316,229,"0205",686,9,677
"5402",5402,18,254,377,279,"0206",1873,109,1764
"5403",5403,14,189,277,206,"0207",2915,351,2564
"5404",5404,49,509,799,565,"0209",2878,62,2816
"5405",5405,64,471,727,543,"0210",685,12,673
"5406",5406,30,238,395,269,"0211",3235,108,3127
"5407",5407,28,259,423,299,"0212",841,94,747
"5408",5408,79,371,668,454,"0213",368,37,331
"5409",5409,70,303,624,376,"0215",2519,194,2325
"5410",5410,38,143,297,186,"0216",2058,85,1973
"5411",5411,53,174,374,233,"0217",422,8,414
"5412",5412,28,196,339,229,"0218",1447,29,1418
"5413",5413,5,64,112,76,"0219",2539,58,2481
"5414",5414,21,72,139,96,"0220",927,44,883
"5415",5415,17,162,252,193,"0221",2240,118,2122
"5416",5416,14,96,142,111,"0222",7,1,6
"5417",5417,0,0,0,0,"0223",573,69,504
"5418",5418,0,0,0,0,"0224",196,61,135
"5419",5419,0,0,0,0,"0225",480,23,457
"5420",5420,0,0,0,0,"0226",40,0,40
"5421",5421,900,657,2302,1591,"0227",6885,71,6814
"5422",5422,1073,370,2496,1487,"0228",6052,97,5955
"5423",5423,1122,366,2810,1527,"0229",2323,27,2296
"5424",5424,778,325,1892,1138,"0230",1218,178,1040
"5425",5425,977,368,2199,1390,"0231",689,100,589
"5426",5426,548,340,1513,915,"0232",2758,55,2703
"5427",5427,1124,195,2485,1357,"0233",9,0,9
"5428",5428,540,120,1284,690,"0234",2390,51,2339
"5429",5429,449,257,1094,725,"0235",394,71,323
"5430",5430,181,122,462,312,"0236",963,122,841
"5431",5431,383,140,787,548,"0237",1207,22,1185
"5432",5432,593,384,1634,1002,"0238",192,6,186
"5433",5433,804,443,2541,1283,"0239",4395,398,3997
"5434",5434,1347,356,3361,1743,"0240",1518,158,1360
"5435",5435,365,157,833,538,"0241",2299,43,2256
"5436",5436,1303,380,3782,1722,"0242",83,7,76
"5437",5437,474,130,1171,619,"0243",82,9,73
"5438",5438,0,0,1,0,"0244",1244,72,1172
"5439",5439,1349,730,3192,2140,"0245",932,5,927
"5440",5440,400,304,1032,716,"0246",23,0,23
"5441",5441,1255,909,3290,2222,"0247",253,12,241
"5442",5442,1004,683,2548,1730,"0248",111,0,111
"5443",5443,77,66,185,148,"0249",605,44,561
"5444",5444,11,5,30,16,"0250",464,14,450
"5445",5445,5,4,17,10,"0251",18,1,17
"5446",5446,222,188,593,420,"0252",9,6,3
"5447",5447,1211,983,3037,2287,"0253",576,129,447
"5448",5448,1119,695,2671,1857,"0254",709,8,701
"5449",5449,1033,655,2671,1741,"0255",345,85,260
"5450",5450,35,51,108,87,"0256",1844,20,1824
"5451",5451,1144,712,2707,1896,"0257",651,13,638
"5452",5452,893,532,1852,1449,"0002",1400,762,638
"5453",5453,1395,721,3005,2177,"0003",2916,934,1982
"5454",5454,949,555,2323,1544,"0004",2714,1765,949
"5455",5455,1113,624,2679,1785,"0005",724,583,141
"5456",5456,920,545,1908,1491,"0006",457,376,81
"5457",5457,612,852,1838,1498,"0007",522,442,80
"5458",5458,666,925,1981,1621,"0008",325,271,54
"5459",5459,989,606,2452,1638,"0009",738,416,322
"5460",5460,236,62,504,312,"0010",2485,1545,940
"5461",5461,657,589,1747,1278,"0012",938,752,186
"5462",5462,742,992,2122,1765,"0013",3418,2756,662
"5463",5463,190,284,607,483,"0014",1154,1045,109
"5464",5464,142,50,284,195,"0015",517,394,123
"5465",5465,391,138,808,553,"0016",433,301,132
"5466",5466,1421,615,3253,2097,"0018",248,174,74
"5467",5467,880,1166,2509,2085,"0019",498,418,80
"5468",5468,1192,1591,3560,2843,"0020",1181,982,199
"5469",5469,1098,691,2686,1840,"0021",2135,1895,240
"5470",5470,1010,1609,3311,2680,"0022",2006,1771,235
"5471",5471,864,1050,2374,1945,"0023",540,416,124
"5472",5472,359,661,1268,1041,"0024",1435,1043,392
"5473",5473,887,447,2127,1377,"0027",702,641,61
"5474",5474,444,517,1229,984,"0011",926,611,315
"5475",5475,14,22,38,36,"0014",896,585,311
"5476",5476,1000,1502,3161,2558,"0015",657,441,216
"5477",5477,849,724,2440,1622,"0016",2125,1393,732
"5478",5478,757,210,1884,992,"0021",2841,1136,1705
"5479",5479,909,781,2174,1738,"0024",985,507,478
"5480",5480,53,32,165,87,"0032",2509,923,1586
"5481",5481,0,0,0,0,"0033",125,89,36
"5482",5482,729,493,1776,1270,"0035",268,110,158
"5483",5483,784,495,1886,1314,"0036",725,155,570
"5484",5484,0,0,0,0,"0043",340,221,119
"5485",5485,0,0,0,0,"0044",860,450,410
"5486",5486,979,969,5014,2001,"0045A",1326,621,705
"5487",5487,267,400,856,681,"0045B",590,235,355
"5488",5488,1115,1076,2815,2248,"0046",764,472,292
"5489",5489,527,559,1384,1109,"0001",1639,1438,201
"5490",5490,675,954,2085,1668,"0002",4637,3825,812
"5491",5491,1438,1398,939,2911,"0003",3509,2922,587
"5492",5492,554,737,1541,1321,"0004",3146,2340,806
"5493",5493,287,154,511,450,"0005",2459,2170,289
"5494",5494,168,255,525,432,"0007",941,847,94
"5495",5495,742,1084,2294,1868,"0008",3375,2751,624
"5496",5496,1350,1132,3035,2535,"0009",4899,4101,798
"5497",5497,1035,1072,2563,2157,"0010",5359,4690,669
"5498",5498,1041,1333,2939,2428,"0011",2434,1894,540
"5499",5499,865,932,2256,1844,"0012",2470,1921,549
"5500",5500,939,986,2392,1988,"0013",4164,3615,549
"5501",5501,665,928,1978,1631,"0014",3997,3243,754
"5502",5502,673,985,2056,1697,"0015",817,597,220
"5503",5503,408,605,1248,1032,"0016",5363,4922,441
"5504",5504,175,261,534,444,"0001",2696,2011,685
"5505",5505,650,684,1614,1363,"0002",2011,1297,714
"5506",5506,50,293,513,354,"0003",2469,1716,753
"5507",5507,49,286,492,341,"0004",1698,1239,459
"5508",5508,0,25,27,25,"0005",710,541,169
"5509",5509,53,403,592,465,"0008",275,237,38
"5510",5510,1,29,41,31,"0011",923,815,108
"5511",5511,12,71,92,84,"0012",280,256,24
"5512",5512,24,291,456,322,"0013",1307,865,442
"5513",5513,17,88,137,107,"0014",1361,1011,350
"5514",5514,97,481,874,591,"0016",1215,1046,169
"5515",5515,39,157,322,205,"0017",1380,1140,240
"5516",5516,498,276,1661,792,"001A",2020,1541,479
"5517",5517,284,871,1691,1180,"0020",688,590,98
"5518",5518,198,1107,2251,1323,"0023",330,236,94
"5519",5519,411,1104,2318,1533,"0024",853,737,116
"5520",5520,269,1076,2009,1361,"0025",480,385,95
"5521",5521,223,1192,2126,1436,"002A",1542,783,759
"5522",5522,111,450,872,569,"0036",1123,967,156
"5523",5523,243,1682,2749,1961,"003A",2332,1718,614
"5524",5524,281,1305,2180,1598,"004A",2178,1503,675
"5525",5525,153,893,1494,1060,"0001",1461,690,771
"5526",5526,130,702,1163,844,"0002",1637,1079,558
"5527",5527,193,333,1064,542,"0003",1843,618,1225
"5528",5528,317,951,1855,1294,"0004",2275,1340,935
"5529",5529,137,558,977,701,"0005",1513,1267,246
"5530",5530,204,1204,2010,1426,"0006",1340,908,432
"5531",5531,189,732,1422,933,"0007",977,762,215
"5532",5532,325,1461,2794,1808,"0008",390,347,43
"5533",5533,230,1117,1867,1363,"0009",462,401,61
"5534",5534,76,409,675,492,"0010",301,240,61
"5535",5535,132,739,1324,884,"0011",135,105,30
"5536",5536,353,1482,2779,1855,"0012",139,113,26
"5537",5537,235,507,1114,752,"0014",257,220,37
"5538",5538,430,1874,3129,2333,"0015",244,187,57
"5539",5539,324,1330,2576,1676,"0016",329,277,52
"5540",5540,264,1342,2678,1629,"0017",2762,979,1783
"5541",5541,276,1137,2355,1436,"0018",143,90,53
"5542",5542,300,1416,2681,1742,"0019",729,572,157
"5543",5543,138,1023,1579,1173,"0020",241,212,29
"5544",5544,256,120,873,382,"0021",370,274,96
"5545",5545,579,496,2166,1093,"0022",338,236,102
"5546",5546,371,198,1226,590,"0011",2258,604,1654
"5547",5547,1090,607,2772,1726,"0012",896,175,721
"5548",5548,587,400,1977,1017,"0013",5133,751,4382
"5549",5549,712,626,2313,1362,"0014",364,115,249
"5550",5550,1025,814,3271,1869,"0016",213,87,126
"5551",5551,568,557,1761,1139,"0024",436,352,84
"5552",5552,1134,852,3006,2012,"0025",1281,822,459
"5553",5553,788,479,2481,1294,"0026",936,435,501
"5554",5554,738,487,1917,1280,"0032",226,130,96
"5555",5555,88,71,250,163,"0033",2076,1187,889
"5556",5556,1513,1001,3912,2556,"0034",2114,1326,788
"5557",5557,445,251,1173,717,"0035",599,303,296
"5558",5558,217,158,707,378,"0037",0,0,0
"5559",5559,1039,422,2508,1512,"0042",1126,429,697
"5560",5560,533,371,1350,944,"0045",1082,648,434
"5561",5561,82,84,364,168,"0046",1309,518,791
"5562",5562,50,70,162,122,"0103",257,132,125
"5563",5563,1150,941,3319,2152,"0104",165,100,65
"5564",5564,147,92,443,243,"0105",0,0,0
"5565",5565,239,121,845,371,"012A",318,120,198
"5566",5566,698,353,2000,1080,"0205",1384,1118,266
"5567",5567,23,56,113,79,"0207",1175,913,262
"5568",5568,890,576,2473,1483,"0208",158,121,37
"5569",5569,326,130,1034,465,"0209",0,0,0
"5570",5570,316,134,1051,459,"0304",748,484,264
"5571",5571,832,601,2830,1459,"0404",777,514,263
"5572",5572,309,350,1039,669,"0405",490,357,133
"5573",5573,1447,873,4002,2352,"0408",52,45,7
"5574",5574,587,446,1827,1044,"0409",649,470,179
"5575",5575,844,480,2163,1356,"207C",640,402,238
"5576",5576,622,249,1313,885,"0001",1271,729,542
"5577",5577,319,188,875,515,"0002",650,41,609
"5578",5578,1155,581,3203,1783,"0004",373,153,220
"5579",5579,1162,607,3326,1802,"003N",216,96,120
"5580",5580,324,199,981,531,"003S",157,12,145
"5581",5581,1175,965,3337,2162,"0101",1327,1070,257
"5582",5582,682,364,2132,1070,"0102",1612,1246,366
"5583",5583,767,419,2793,1204,"0103",818,671,147
"5584",5584,1029,592,3690,1651,"0104",1155,798,357
"5585",5585,1028,760,3272,1813,"0105",1265,648,617
"5586",5586,566,392,1872,978,"0106",3363,1941,1422
"5587",5587,574,312,2110,895,"0107",3878,2789,1089
"5588",5588,508,412,1378,935,"0108",2454,1371,1083
"5589",5589,117,85,338,205,"0109",1626,1230,396
"5590",5590,512,309,1895,832,"0210",1216,711,505
"5591",5591,1037,640,3463,1705,"0211",702,512,190
"5592",5592,885,502,2721,1406,"0212",1994,1326,668
"5593",5593,725,743,2346,1522,"0213",1131,909,222
"5594",5594,734,616,1985,1423,"0214",4512,3554,958
"5595",5595,1298,1028,3291,2358,"0215",8109,5757,2352
"5596",5596,946,643,2869,1612,"0216",2594,1938,656
"5597",5597,595,532,1595,1134,"0217",1764,1471,293
"5598",5598,844,463,2677,1341,"0318",830,683,147
"5599",5599,924,473,2734,1429,"0319",2115,1813,302
"5600",5600,270,158,976,436,"0320",3738,3026,712
"5601",5601,1110,767,3412,1897,"0321",2039,1732,307
"5602",5602,764,488,2296,1277,"0322",1834,1332,502
"5603",5603,1058,722,3250,1799,"0323",3060,2595,465
"5604",5604,674,400,2489,1104,"0324",1968,1550,418
"5605",5605,889,842,2500,1756,"0325",2887,2397,490
"5606",5606,224,141,721,368,"0426",731,566,165
"5607",5607,714,479,2734,1229,"0427",5408,2885,2523
"5608",5608,841,585,2297,1440,"0428",3298,1885,1413
"5609",5609,457,208,1305,674,"0429",361,341,20
"5610",5610,847,532,2225,1400,"0430",940,592,348
"5611",5611,994,802,3413,1822,"0431",613,361,252
"5612",5612,993,827,3920,1834,"0432",856,736,120
"5613",5613,535,355,1936,899,"0433",4479,1107,3372
"5614",5614,56,33,205,89,"0434",1466,1219,247
"5615",5615,500,298,1250,806,"0011",1998,1462,536
"5616",5616,983,981,2697,1987,"0014",2060,1665,395
"5617",5617,329,279,929,616,"0021",3291,2793,498
"5618",5618,18,32,80,50,"0023",484,367,117
"5619",5619,3,13,26,16,"0031",1722,1416,306
"5620",5620,630,430,1740,1084,"0033",2323,1411,912
"5621",5621,666,505,2060,1198,"0041",63,50,13
"5622",5622,485,245,1426,748,"0042",3489,1753,1736
"5623",5623,310,248,940,603,"0100",275,171,104
"5624",5624,785,568,2157,1367,"0200",292,232,60
"5625",5625,1,4,10,5,"0300",308,228,80
"5626",5626,1317,1333,3700,2677,"0400",309,251,58
"5627",5627,853,639,2452,1510,"0001",2395,1505,890
"5628",5628,1175,693,3499,1902,"0002",1235,1099,136
"5629",5629,215,176,599,395,"0003",204,149,55
"5630",5630,348,210,1248,565,"0004",753,654,99
"5631",5631,762,458,2562,1238,"0005",619,562,57
"5632",5632,5,1,7,6,"0006",1443,1166,277
"5633",5633,1703,758,4457,2510,"0001",2671,1333,1338
"5634",5634,289,236,991,539,"0002",2706,1594,1112
"5635",5635,88,60,330,152,"0003",2433,1665,768
"5636",5636,58,65,194,126,"0004",433,321,112
"5637",5637,677,459,2745,1160,"0005",700,466,234
"5638",5638,1250,712,4233,1990,"0006",1002,463,539
"5639",5639,990,826,2697,1845,"0007",127,107,20
"5640",5640,806,476,2438,1309,"0008",626,449,177
"5641",5641,1242,784,3899,2054,"0009",642,501,141
"5642",5642,877,653,3314,1561,"0001",54,47,7
"5643",5643,835,762,2682,1629,"0002",667,623,44
"5644",5644,209,292,711,512,"0003",1136,981,155
"5645",5645,320,409,1062,736,"0004",701,666,35
"5646",5646,992,902,2915,1930,"0005",151,122,29
"5647",5647,834,612,2915,1461,"0006",1516,815,701
"5648",5648,1185,825,3211,2037,"0007",1384,570,814
"5649",5649,996,753,2520,1772,"0008",1188,550,638
"5650",5650,865,486,2395,1374,"0009",2113,1933,180
"5651",5651,782,334,2330,1138,"0010",2169,1949,220
"5652",5652,1091,534,3319,1649,"0011",462,410,52
"5653",5653,404,202,1224,618,"0012",717,544,173
"5654",5654,799,623,2360,1445,"0013",519,378,141
"5655",5655,593,250,1798,860,"0014",2956,2379,577
"5656",5656,1361,1017,4011,2410,"0015",2879,2549,330
"5657",5657,1243,1154,3517,2426,"0016",399,367,32
"5658",5658,930,512,2984,1470,"0017",1157,1081,76
"5659",5659,690,442,2018,1146,"0019",1966,1438,528
"5660",5660,903,619,2932,1547,"0020",1525,597,928
"5661",5661,712,531,1917,1264,"0021",1880,1006,874
"5662",5662,479,222,1163,713,"0001",566,406,160
"5663",5663,757,436,2378,1223,"0002",314,201,113
"5664",5664,63,28,127,94,"0003",357,227,130
"5665",5665,785,582,2513,1402,"0004",240,133,107
"5666",5666,351,222,909,582,"0005",234,197,37
"5667",5667,503,412,1353,929,"0001",2393,233,2160
"5668",5668,309,219,1034,536,"0002",1252,222,1030
"5669",5669,543,421,1571,980,"0003",2547,116,2431
"5670",5670,378,189,1078,584,"0004",1676,1226,450
"5671",5671,712,455,2316,1181,"0005",1905,764,1141
"5672",5672,46,68,163,114,"0006",1892,462,1430
"5673",5673,348,359,1258,713,"0007",1959,781,1178
"5674",5674,10,4,21,14,"0008",941,111,830
"5675",5675,343,160,1086,511,"0009",4155,3141,1014
"5676",5676,33,36,111,69,"0010",1224,252,972
"5677",5677,848,851,2497,1724,"0011",822,320,502
"5678",5678,604,438,1780,1057,"0012",525,29,496
"5679",5679,588,422,1652,1023,"0013",360,7,353
"5680",5680,12,14,44,26,"0014",2092,83,2009
"5681",5681,142,67,536,212,"0015",2005,133,1872
"5682",5682,146,76,502,226,"0016",815,58,757
"5683",5683,5,1,9,6,"0017",3216,1268,1948
"5684",5684,35,18,88,55,"0018",1653,47,1606
"5685",5685,621,440,2063,1075,"0019",2124,131,1993
"5686",5686,1094,754,3295,1870,"0020",1901,216,1685
"5687",5687,12,11,49,25,"0021",5944,2229,3715
"5688",5688,293,247,1008,560,"0022",5347,1948,3399
"5689",5689,621,336,2193,997,"0023",2307,610,1697
"5690",5690,47,40,169,89,"0024",487,346,141
"5691",5691,32,14,110,47,"0025",2737,1963,774
"5692",5692,35,12,101,47,"0026",3131,1718,1413
"5693",5693,404,307,1265,722,"0027",1811,698,1113
"5694",5694,1200,936,3047,2165,"0028",924,311,613
"5695",5695,880,672,2425,1566,"0029",2052,1640,412
"5696",5696,112,59,302,173,"0030",1284,1111,173
"5697",5697,813,516,2592,1346,"0031",1402,1148,254
"5698",5698,216,127,569,346,"0032",260,201,59
"5699",5699,616,325,1998,968,"0033",4289,2010,2279
"5700",5700,432,260,1168,704,"0034",1581,92,1489
"5701",5701,1131,832,3602,1996,"0035",1692,1083,609
"5702",5702,188,87,597,281,"0036",2121,1631,490
"5703",5703,137,113,380,254,"0037",2918,2297,621
"5704",5704,743,506,2068,1264,"0038",2440,2026,414
"5705",5705,221,213,623,439,"0039",2032,70,1962
"5706",5706,822,493,2923,1326,"0040",3441,2768,673
"5707",5707,652,665,2070,1339,"0041",218,162,56
"5708",5708,243,240,724,490,"0042",2682,2101,581
"5709",5709,195,180,651,382,"0043",3059,2074,985
"5710",5710,173,226,568,405,"0044",1112,241,871
"5711",5711,124,67,394,195,"0045",2206,370,1836
"5712",5712,148,135,420,296,"0046",2139,293,1846
"5713",5713,252,206,825,471,"0047",2374,382,1992
"5714",5714,6,5,19,12,"0048",1991,103,1888
"5715",5715,13,11,49,25,"0049",1123,76,1047
"5716",5716,434,396,1557,849,"0050",3320,210,3110
"5717",5717,294,175,973,489,"0051",666,31,635
"5718",5718,427,254,1176,689,"0052",528,16,512
"5719",5719,402,248,1359,660,"0053",1706,90,1616
"5720",5720,207,149,731,365,"0054",521,36,485
"5721",5721,5,12,25,17,"0055",368,9,359
"5722",5722,129,82,463,212,"0056",3651,2748,903
"5723",5723,62,36,214,103,"0057",811,20,791
"5724",5724,238,375,847,615,"0058",44,38,6
"5725",5725,276,154,1064,445,"0059",1225,23,1202
"5726",5726,811,509,2810,1340,"0060",4319,2864,1455
"5727",5727,14,13,35,27,"0061",2950,1110,1840
"5728",5728,0,0,0,0,"0062",2864,2027,837
"5729",5729,75,28,255,106,"0063",1282,68,1214
"5730",5730,790,645,2563,1466,"0064",854,207,647
"5731",5731,684,617,2293,1315,"0065",1842,1425,417
"5732",5732,230,123,828,354,"0066",1582,1147,435
"5733",5733,165,127,475,295,"0067",2904,328,2576
"5734",5734,176,128,474,306,"0068",2720,1494,1226
"5735",5735,140,114,515,257,"0069",4127,2775,1352
"5736",5736,186,124,466,314,"0070",3330,836,2494
"5737",5737,614,636,2050,1269,"0071",90,67,23
"5738",5738,254,388,974,656,"0072",3943,1582,2361
"5739",5739,285,239,855,533,"0073",2323,1555,768
"5740",5740,259,217,1135,496,"0074",3201,2520,681
"5741",5741,204,195,623,414,"0075",1205,224,981
"5742",5742,927,796,2549,1740,"0076",2158,260,1898
"5743",5743,885,667,2216,1577,"0077",1803,89,1714
"5744",5744,471,373,1136,848,"0078",2203,676,1527
"5745",5745,249,318,872,573,"0079",2278,1280,998
"5746",5746,1547,1074,4146,2662,"0080",306,238,68
"5747",5747,191,189,759,386,"0081",834,10,824
"5748",5748,78,45,294,123,"0082",4408,1231,3177
"5749",5749,462,296,1312,765,"0083",1463,1146,317
"5750",5750,938,709,2400,1661,"0084",1264,52,1212
"5751",5751,26,13,73,39,"0085",1429,328,1101
"5752",5752,408,246,1626,674,"0086",2302,1117,1185
"5753",5753,124,115,448,242,"0087",1504,200,1304
"5754",5754,90,109,316,203,"0088",1639,564,1075
"5755",5755,574,381,1801,969,"0089",900,216,684
"5756",5756,62,37,204,101,"0090",60,14,46
"5757",5757,759,424,1987,1205,"0091",689,586,103
"5758",5758,388,321,1283,721,"0092",1337,841,496
"5759",5759,601,317,1698,930,"0093",1439,202,1237
"5760",5760,60,36,216,97,"0094",2069,1378,691
"5761",5761,288,202,924,493,"0095",843,374,469
"5762",5762,368,280,1308,655,"0096",826,90,736
"5763",5763,206,137,608,349,"0097",3,0,3
"5764",5764,422,375,1323,810,"0098",963,444,519
"5765",5765,1,8,12,9,"0099",1255,459,796
"5766",5766,172,201,480,375,"0100",3304,1712,1592
"5767",5767,78,104,216,184,"0101",0,0,0
"5768",5768,115,43,326,159,"0102",201,122,79
"5769",5769,822,639,2301,1493,"0103",77,41,36
"5770",5770,1078,612,3942,1732,"0104",72,59,13
"5771",5771,501,331,1615,851,"0105",515,178,337
"5772",5772,296,217,1318,521,"0106",14,10,4
"5773",5773,332,354,914,694,"0107",3717,851,2866
"5774",5774,95,87,347,185,"0108",616,481,135
"5775",5775,402,234,1369,655,"0109",252,229,23
"5776",5776,0,0,5,0,"0001",856,64,792
"5777",5777,726,530,2245,1301,"0002",873,103,770
"5778",5778,91,93,262,186,"0003",870,100,770
"5779",5779,149,150,446,301,"0004",915,68,847
"5780",5780,350,180,876,541,"0005",2,0,2
"5781",5781,37,49,115,86,"0001",814,138,676
"5782",5782,696,611,2372,1327,"0002",649,283,366
"5783",5783,299,224,909,534,"0003",1148,645,503
"5784",5784,137,84,644,225,"0004",1345,182,1163
"5785",5785,11,9,36,20,"0005",239,27,212
"5786",5786,27,31,75,58,"0006",1348,141,1207
"5787",5787,257,182,741,445,"0007",3002,780,2222
"5788",5788,106,52,382,161,"0008",3987,1671,2316
"5789",5789,2,0,3,2,"0009",921,118,803
"5790",5790,65,34,163,101,"0010",2547,149,2398
"5791",5791,16,10,47,26,"0011",910,99,811
"5792",5792,150,88,401,239,"0012",2543,415,2128
"5793",5793,46,27,176,74,"0013",595,20,575
"5794",5794,6,0,9,6,"0014",201,44,157
"5795",5795,5,6,12,11,"0015",1877,271,1606
"5796",5796,136,99,415,244,"0016",1031,80,951
"5797",5797,675,505,2560,1201,"0017",1572,207,1365
"5798",5798,76,72,249,152,"0018",489,51,438
"5799",5799,102,140,338,244,"0019",452,168,284
"5800",5800,184,120,492,322,"0020",862,52,810
"5801",5801,6,4,19,10,"0022",2098,154,1944
"5802",5802,265,187,878,460,"0001",1371,1095,276
"5803",5803,281,869,1839,1162,"0002",7509,5320,2189
"5804",5804,200,1381,2254,1595,"0003",5684,4236,1448
"5805",5805,323,293,1360,628,"0004",8364,6432,1932
"5806",5806,253,1309,2386,1574,"0005",4780,3719,1061
"5807",5807,108,833,1358,948,"0006",509,430,79
"5808",5808,250,756,1705,1018,"0007",6924,5633,1291
"5809",5809,126,586,1055,721,"0008",12762,5850,6912
"5810",5810,247,1330,2381,1583,"0009",1278,1077,201
"5811",5811,186,715,1443,912,"0010",6174,3727,2447
"5812",5812,329,1142,2391,1496,"0011",4238,3396,842
"5813",5813,82,432,834,518,"0012",3388,2671,717
"5814",5814,219,853,1775,1083,"0013",2445,1907,538
"5815",5815,256,1427,2768,1695,"0014",537,419,118
"5816",5816,39,225,365,265,"0015",1709,1345,364
"5817",5817,83,506,856,597,"0016",665,494,171
"5818",5818,40,267,533,311,"0017",6148,3801,2347
"5819",5819,200,1194,1903,1403,"0018",5691,3974,1717
"5820",5820,245,968,2258,1223,"0019",6771,5303,1468
"5821",5821,71,487,1082,568,"0020",2294,928,1366
"5822",5822,271,880,2383,1161,"0021",2009,1656,353
"5823",5823,5,67,94,72,"0022",6494,3769,2725
"5824",5824,19,78,177,100,"0023",2923,2382,541
"5825",5825,78,131,567,213,"0024",1840,1336,504
"5826",5826,24,187,328,213,"0025",3148,1618,1530
"5827",5827,126,389,841,519,"0026",1676,1380,296
"5828",5828,210,794,1707,1016,"0027",2675,2216,459
"5829",5829,71,363,666,441,"0028",2336,1873,463
"5830",5830,323,1234,2201,1584,"0029",1303,1084,219
"5831",5831,411,1733,3143,2174,"0030",1775,1449,326
"5832",5832,217,1507,2352,1749,"0031",2063,1591,472
"5833",5833,67,628,963,707,"0032",4479,3125,1354
"5834",5834,226,963,1929,1213,"0033",1759,1230,529
"5835",5835,529,2002,3828,2585,"0034",3015,2411,604
"5836",5836,266,1151,2104,1441,"0035",4955,3744,1211
"5837",5837,468,2306,3336,2813,"0036",2274,973,1301
"5838",5838,366,1841,2676,2241,"0101",1596,1031,565
"5839",5839,316,1617,2495,1969,"0102",324,101,223
"5840",5840,402,1934,3110,2376,"0103",732,415,317
"5841",5841,539,2211,3836,2791,"0201",2031,1277,754
"5842",5842,269,1396,2164,1700,"0202",369,313,56
"5843",5843,304,1139,2333,1468,"0203",495,219,276
"5844",5844,390,1863,3066,2286,"0301",300,254,46
"5845",5845,547,2863,4633,3471,"0302",6045,2401,3644
"5846",5846,61,284,570,352,"0303",1242,1133,109
"5847",5847,302,1237,2301,1563,"0401",1627,1414,213
"5848",5848,328,1050,2170,1402,"0402",1426,997,429
"5849",5849,316,911,1989,1241,"0001",1771,604,1167
"5850",5850,161,842,1449,1020,"0002",169,144,25
"5851",5851,51,339,581,393,"0003",127,104,23
"5852",5852,40,172,312,214,"0004",3574,1039,2535
"5853",5853,90,453,840,548,"0005",896,328,568
"5854",5854,24,200,295,224,"0006",189,176,13
"5855",5855,130,548,1061,687,"0007",575,442,133
"5856",5856,105,631,1088,747,"0008",171,126,45
"5857",5857,81,754,1169,843,"0009",235,155,80
"5858",5858,142,742,1301,899,"0010",333,273,60
"5859",5859,180,674,1262,867,"0011",675,310,365
"5860",5860,53,387,630,444,"0012",1726,572,1154
"5861",5861,25,205,352,234,"0013",51,25,26
"5862",5862,65,493,774,566,"0014",1176,257,919
"5863",5863,41,269,417,313,"0015",187,59,128
"5864",5864,334,410,1314,764,"0001",4558,2243,2315
"5865",5865,75,613,960,695,"0002",2066,1328,738
"5866",5866,237,864,1700,1123,"0003",5554,3420,2134
"5867",5867,266,925,1931,1212,"0004",5158,3456,1702
"5868",5868,290,469,1160,763,"0005",3365,1027,2338
"5869",5869,276,705,1431,989,"0006",2654,2039,615
"5870",5870,528,324,1506,859,"0007",8473,3789,4684
"5871",5871,355,888,1823,1256,"0008",3113,1474,1639
"5872",5872,125,833,1300,966,"0009",2197,1494,703
"5873",5873,190,588,1111,787,"0010",2946,2311,635
"5874",5874,67,573,884,644,"0011",2493,1689,804
"5875",5875,44,245,354,291,"0012",2562,1971,591
"5876",5876,22,341,451,363,"0013",5695,2917,2778
"5877",5877,39,177,290,217,"0014",6247,2972,3275
"5878",5878,12,93,134,108,"0015",3840,2933,907
"5879",5879,15,91,135,106,"0016",3984,3296,688
"5880",5880,20,168,254,189,"0017",1821,1544,277
"5881",5881,42,155,257,200,"0018",2785,2182,603
"5882",5882,17,204,306,226,"0019",3233,2145,1088
"5883",5883,11,220,315,233,"0020",2229,1255,974
"5884",5884,41,90,178,131,"0021",3570,2331,1239
"5885",5885,106,374,663,483,"0022",1366,1098,268
"5886",5886,13,154,238,168,"0023",1864,1042,822
"5887",5887,58,209,357,268,"0024",1669,1092,577
"5888",5888,43,159,274,203,"0025",1480,869,611
"5889",5889,237,308,1507,552,"0026",2937,804,2133
"5890",5890,167,178,803,350,"0027",4810,2859,1951
"5891",5891,80,152,494,238,"0028",2499,1664,835
"5892",5892,20,80,207,100,"0029",5713,2070,3643
"5893",5893,26,60,212,89,"0030",2765,1637,1128
"5894",5894,65,275,433,344,"1010",3332,2222,1110
"5895",5895,177,641,1199,824,"1110",4825,3806,1019
"5896",5896,52,171,416,229,"2020",2221,1844,377
"5897",5897,18,49,118,67,"2080",4320,3167,1153
"5898",5898,215,754,1612,978,"2120",4773,3781,992
"5899",5899,236,647,1497,898,"3030",2509,2041,468
"5900",5900,38,154,393,195,"3040",4367,3125,1242
"5901",5901,0,0,0,0,"3060",668,531,137
"5902",5902,84,207,697,298,"4050",3477,2203,1274
"5903",5903,114,473,880,593,"4070",359,285,74
"5904",5904,152,369,1121,529,"4100",3328,2675,653
"5905",5905,16,90,195,107,"0001",70,15,55
"5906",5906,4,85,136,90,"0002",54,13,41
"5907",5907,0,0,0,0,"0003",38,8,30
"5908",5908,20,52,133,73,"0004",52,21,31
"5909",5909,79,899,1351,984,"0005",37,1,36
"5910",5910,45,617,978,665,"0006",16,2,14
"5911",5911,0,0,1,0,"0101",227,205,22
"5912",5912,0,0,0,0,"0201",31,31,0
"5913",5913,42,355,595,403,"0202",96,83,13
"5914",5914,66,381,717,450,"0301",66,54,12
"5915",5915,21,201,352,222,"0302",39,38,1
"5916",5916,3,39,52,43,"0401",149,121,28
"5917",5917,23,333,558,360,"0101",3159,2370,789
"5918",5918,60,364,626,428,"0107",1083,768,315
"5919",5919,9,120,188,131,"0109",1577,1263,314
"5920",5920,133,301,766,438,"0113",1747,1427,320
"5921",5921,72,111,335,187,"0118",797,596,201
"5922",5922,72,174,492,249,"0119",2548,1940,608
"5923",5923,27,73,191,102,"0202",2931,2029,902
"5924",5924,67,112,295,181,"0211",2807,1653,1154
"5925",5925,121,719,1256,849,"0215",3605,2607,998
"5926",5926,61,263,488,330,"0220",2477,2207,270
"5927",5927,80,450,734,538,"0303",959,825,134
"5928",5928,124,577,984,713,"0308",816,390,426
"5929",5929,141,305,831,459,"0312",4982,3106,1876
"5930",5930,492,723,2188,1246,"0314",3050,1539,1511
"5931",5931,572,1352,3055,1975,"0404",989,842,147
"5932",5932,343,587,1682,964,"0405",1689,1472,217
"5933",5933,144,761,1321,913,"0406",3625,2781,844
"5934",5934,111,392,892,512,"0410",288,229,59
"5935",5935,132,336,726,478,"0416",2223,1549,674
"5936",5936,84,285,511,375,"0417",1918,1561,357
"5937",5937,86,632,978,724,"0001",727,542,185
"5938",5938,249,1197,2034,1471,"0002",638,461,177
"5939",5939,195,940,1599,1157,"0003",269,215,54
"5940",5940,61,457,742,529,"0004",536,339,197
"5941",5941,181,1110,1954,1317,"0006",425,381,44
"5942",5942,280,1258,2730,1556,"0007",371,323,48
"5943",5943,163,810,1560,986,"0009",591,452,139
"5944",5944,102,585,1293,695,"0001",50,43,7
"5945",5945,315,1698,2842,2040,"0002",41,31,10
"5946",5946,467,1410,2698,1929,"0003",57,50,7
"5947",5947,452,1563,2795,2044,"0004",41,41,0
"5948",5948,73,264,505,344,"0001",672,364,308
"5949",5949,767,842,2942,1653,"0002",416,134,282
"5950",5950,484,760,2119,1281,"0003",505,116,389
"5951",5951,72,242,400,319,"0004",981,718,263
"5952",5952,137,266,657,416,"0011",2640,969,1671
"5953",5953,101,259,568,364,"0012",1435,471,964
"5954",5954,172,994,1658,1179,"0013",1547,290,1257
"5955",5955,741,366,2485,1143,"0014",567,109,458
"5956",5956,147,843,1420,1009,"0021",502,42,460
"5957",5957,275,1485,2720,1787,"0022",1423,409,1014
"5958",5958,136,696,1248,843,"0023",1968,301,1667
"5959",5959,606,2675,4789,3336,"0024",2626,562,2064
"5960",5960,239,1061,1897,1323,"0031",1922,600,1322
"5961",5961,123,1080,1764,1227,"0032",1405,309,1096
"5962",5962,147,1105,1743,1271,"0033",670,219,451
"5963",5963,199,2128,3346,2370,"0034",663,445,218
"5964",5964,46,398,680,452,"0035",1310,301,1009
"5965",5965,105,1102,1719,1221,"0041",668,52,616
"5966",5966,108,765,1502,899,"0042",1011,87,924
"5967",5967,5,49,70,54,"0043",1842,341,1501
"5968",5968,232,1054,2680,1321,"0044",733,135,598
"5969",5969,32,177,309,213,"0045",859,36,823
"5970",5970,33,193,335,229,"0101",667,473,194
"5971",5971,20,147,275,168,"0201",179,157,22
"5972",5972,35,246,376,287,"0202",379,208,171
"5973",5973,71,675,1153,758,"0301",544,304,240
"5974",5974,71,738,1127,823,"0302",93,78,15
"5975",5975,17,140,245,158,"0401",664,374,290
"5976",5976,56,592,827,653,"001B",183,148,35
"5977",5977,31,476,674,512,"001C",311,283,28
"5978",5978,85,797,1225,888,"001D",600,501,99
"5979",5979,330,1094,2312,1450,"001E",817,711,106
"5980",5980,189,1327,2265,1542,"001F",834,762,72
"5981",5981,206,1073,1790,1300,"001G",616,536,80
"5982",5982,36,208,362,246,"001H",599,532,67
"5983",5983,56,384,635,443,"001I",191,159,32
"5984",5984,87,310,723,402,"002D",722,554,168
"5985",5985,16,80,135,99,"002E",620,558,62
"5986",5986,45,326,567,377,"002F",243,201,42
"5987",5987,68,429,667,508,"002G",738,570,168
"5988",5988,9,29,44,39,"003D",1076,954,122
"5989",5989,44,488,685,538,"003E",1238,1100,138
"5990",5990,119,688,1187,814,"003F",894,762,132
"5991",5991,64,458,668,532,"003G",583,548,35
"5992",5992,13,102,150,116,"003I",1540,1358,182
"5993",5993,238,513,1215,768,"004B",2022,1748,274
"5994",5994,198,254,796,460,"004C",391,310,81
"5995",5995,276,324,988,615,"004D",1609,1416,193
"5996",5996,125,1268,2022,1416,"004E",808,740,68
"5997",5997,105,1126,1854,1240,"004F",1912,1525,387
"5998",5998,34,268,432,307,"004G",1802,1451,351
"5999",5999,63,351,600,421,"1A3B",1272,821,451
"6000",6000,75,295,509,374,"1A5A",2414,1400,1014
"6001",6001,288,1372,2672,1681,"1E7C",1355,1135,220
"6002",6002,191,1696,2559,1903,"2A1A",1544,597,947
"6003",6003,9,189,297,199,"2B2A",2224,918,1306
"6004",6004,51,961,1431,1026,"2C3A",2408,1382,1026
"6005",6005,302,1177,2065,1503,"3C7G",3570,2347,1223
"6006",6006,400,359,1434,782,"3H3C",1357,965,392
"6007",6007,350,624,1745,998,"4A6E",1907,1396,511
"6008",6008,129,183,381,319,"0001",1217,416,801
"6009",6009,125,177,396,306,"0002",902,182,720
"6010",6010,127,221,458,357,"0003",869,347,522
"6011",6011,45,90,183,135,"0004",118,50,68
"6012",6012,75,113,246,190,"0005",594,220,374
"6013",6013,859,101,1838,976,"0006",443,179,264
"6014",6014,468,113,1070,592,"0007",236,165,71
"6015",6015,999,60,2148,1076,"0008",2428,1143,1285
"6016",6016,437,660,1472,1117,"0009",1057,509,548
"6017",6017,562,462,1574,1044,"0010",655,247,408
"6018",6018,494,224,1299,729,"0011",749,426,323
"6019",6019,530,342,1458,898,"0012",243,180,63
"6020",6020,333,32,876,375,"0001",2343,1577,766
"6021",6021,456,2347,3739,2843,"0002",3746,3009,737
"6022",6022,268,66,806,339,"0003",3028,1935,1093
"6023",6023,167,39,428,211,"0004",1345,1092,253
"6024",6024,257,16,503,276,"0005",611,549,62
"6025",6025,196,11,381,207,"0006",507,431,76
"6026",6026,704,60,1509,777,"0007",976,641,335
"6027",6027,592,105,1355,714,"0008",2344,1718,626
"6028",6028,188,39,479,230,"0009",1956,1465,491
"6029",6029,1048,731,2618,1812,"0001",1056,265,791
"6030",6030,986,32,1802,1032,"0002",1240,524,716
"6031",6031,738,77,1587,826,"0003A",894,79,815
"6032",6032,541,65,1301,618,"0003B",0,0,0
"6033",6033,64,103,302,171,"0004",87,45,42
"6034",6034,1032,649,2640,1714,"0005",1520,319,1201
"6035",6035,1099,370,2079,1488,"0006",431,76,355
"6036",6036,80,299,547,390,"003A",40,24,16
"6037",6037,362,1277,2243,1669,"0001",1298,1060,238
"6038",6038,827,1142,2823,2011,"0002",1583,1208,375
"6039",6039,492,402,1462,910,"0007",294,270,24
"6040",6040,385,217,875,617,"0008",737,665,72
"6041",6041,177,1323,1836,1527,"0009",1402,1163,239
"6042",6042,90,770,1176,868,"0011",380,336,44
"6043",6043,112,820,1241,949,"0012",354,324,30
"6044",6044,39,164,323,206,"0015",206,186,20
"6045",6045,467,994,2478,1490,"0016",532,459,73
"6046",6046,1005,57,1612,1073,"0017",322,289,33
"6047",6047,111,578,1027,706,"0019",493,400,93
"6048",6048,220,860,1618,1106,"0020",106,92,14
"6049",6049,362,1366,2559,1780,"0023",1455,1130,325
"6050",6050,244,1320,2079,1589,"0026",809,230,579
"6051",6051,1049,47,1908,1114,"0027",224,168,56
"6052",6052,354,1728,3017,2129,"0029",1353,1151,202
"6053",6053,26,82,195,111,"0030",2406,1371,1035
"6054",6054,335,1371,2437,1739,"0031",1259,985,274
"6055",6055,356,1253,2303,1632,"0032",468,389,79
"6056",6056,259,191,763,458,"0101",2632,1200,1432
"6057",6057,432,254,1258,703,"0102",309,142,167
"6058",6058,416,215,1277,646,"0103",288,257,31
"6059",6059,518,264,1505,795,"0201",629,561,68
"6060",6060,366,94,1041,469,"0202",1950,1231,719
"6061",6061,167,83,518,257,"0203",455,376,79
"6062",6062,1035,275,2517,1331,"0301",163,133,30
"6063",6063,181,34,453,220,"0302",1577,1291,286
"6064",6064,258,14,501,276,"0303",1617,1256,361
"6065",6065,687,71,1481,768,"0304",274,241,33
"6066",6066,270,12,539,290,"0401",893,513,380
"6067",6067,207,10,423,220,"0402",167,69,98
"6068",6068,465,1922,3195,2422,"0403",315,250,65
"6069",6069,395,15,812,423,"0404",1282,596,686
"6070",6070,45,329,509,380,"0405",622,516,106
"6071",6071,552,18,1166,583,"0001",1759,1386,373
"6072",6072,446,1705,3290,2210,"0002",365,321,44
"6073",6073,410,668,1890,1096,"0003",639,510,129
"6074",6074,695,1228,2681,1974,"0004",956,751,205
"6075",6075,726,39,1450,780,"0005",497,457,40
"6076",6076,387,107,792,501,"0006",1201,1094,107
"6077",6077,426,963,1745,1419,"0007",603,516,87
"6078",6078,248,784,1447,1050,"0008",1194,812,382
"6079",6079,1134,156,2340,1306,"0009",285,252,33
"6080",6080,767,853,2429,1667,"0010",1224,821,403
"6081",6081,552,1668,3326,2265,"0011",1358,815,543
"6082",6082,871,538,2474,1430,"0012",806,562,244
"6083",6083,35,159,285,198,"0013",756,652,104
"6084",6084,1675,1090,4440,2834,"0014",174,144,30
"6085",6085,625,1142,2385,1820,"001A",226,192,34
"6086",6086,299,1689,2893,2030,"005A",100,88,12
"6087",6087,370,63,1066,443,"014A",263,200,63
"6088",6088,375,87,1070,472,"0001",964,790,174
"6089",6089,691,49,1442,749,"0002",1285,1076,209
"6090",6090,761,435,1944,1219,"0003",2264,1889,375
"6091",6091,630,886,2098,1542,"0004",588,415,173
"6092",6092,6,2,269,8,"0005",3163,2040,1123
"6093",6093,406,17,844,428,"0006",1181,899,282
"6094",6094,942,559,2582,1527,"0007",3141,1743,1398
"6095",6095,147,703,1211,868,"0008",2456,2130,326
"6096",6096,505,29,1002,538,"0009",2990,2650,340
"6097",6097,732,108,1273,859,"0010",4184,2795,1389
"6098",6098,419,394,1387,834,"0011",707,407,300
"6099",6099,570,95,1223,682,"0012",2032,1071,961
"6100",6100,518,227,1373,759,"0013",691,593,98
"6101",6101,175,71,480,250,"0014",4578,2234,2344
"6102",6102,47,77,44,126,"0015",552,451,101
"6103",6103,65,498,696,572,"0016",415,356,59
"6104",6104,293,617,1250,934,"0017",661,588,73
"6105",6105,316,89,809,413,"0018",1580,413,1167
"6106",6106,512,1034,2054,1574,"0019",2152,1225,927
"6107",6107,147,252,560,403,"0020",1287,250,1037
"6108",6108,206,53,535,264,"0021",3769,2980,789
"6109",6109,115,27,283,148,"0022",6094,2646,3448
"6110",6110,132,275,615,412,"0023",8203,1607,6596
"6111",6111,304,105,774,420,"0024",1317,964,353
"6112",6112,972,1220,2978,2227,"0025",1122,971,151
"6113",6113,9,13,26,22,"0026",4551,2488,2063
"6114",6114,0,1,3,1,"0027",480,293,187
"6115",6115,40,172,277,215,"0028",1064,897,167
"6116",6116,8,48,78,58,"0029",1703,1312,391
"6117",6117,318,219,1016,553,"0030",2130,1410,720
"6118",6118,315,211,887,538,"0101",2084,1353,731
"6119",6119,267,206,897,491,"0102",642,532,110
"6120",6120,290,193,979,500,"0103",729,607,122
"6121",6121,7,4,16,11,"0104",794,704,90
"6122",6122,135,86,529,229,"0201",807,418,389
"6123",6123,85,264,573,361,"0202",1026,208,818
"6124",6124,166,666,1235,845,"0203",274,93,181
"6125",6125,321,406,1279,748,"0204",601,479,122
"6126",6126,80,65,292,152,"0205",656,282,374
"6127",6127,303,254,1143,574,"0206",441,348,93
"6128",6128,635,898,2543,1559,"0301",2060,1183,877
"6129",6129,489,1529,3600,2068,"0302",1001,535,466
"6130",6130,179,163,796,347,"0303",256,199,57
"6131",6131,635,391,2408,1059,"0304",862,595,267
"6132",6132,243,234,917,488,"0305",350,315,35
"6133",6133,585,506,2342,1102,"0401",2637,998,1639
"6134",6134,149,80,645,233,"0402",510,472,38
"6135",6135,45,84,224,129,"0403",433,324,109
"6136",6136,424,455,1725,893,"0404",430,334,96
"6137",6137,274,146,1036,424,"0405",317,282,35
"6138",6138,464,413,1701,904,"0406",184,178,6
"6139",6139,107,127,471,237,"0106",565,251,314
"6140",6140,42,165,343,210,"0202",186,133,53
"6141",6141,254,115,644,373,"0207A",411,248,163
"6142",6142,504,406,2135,930,"0207B",8,1,7
"6143",6143,44,258,384,307,"0303",399,303,96
"6144",6144,415,1596,3175,2044,"0308",157,125,32
"6145",6145,395,1205,2383,1627,"0404",364,318,46
"6146",6146,660,1783,3984,2505,"0409",214,82,132
"6147",6147,449,1482,2711,1971,"0001",624,421,203
"6148",6148,70,338,507,414,"0002",1226,952,274
"6149",6149,467,1548,2758,2049,"0003",1060,352,708
"6150",6150,834,1230,3152,2113,"0004",1003,610,393
"6151",6151,106,690,1105,802,"0005",272,209,63
"6152",6152,367,1157,2487,1564,"0006",219,165,54
"6153",6153,555,2223,3843,2815,"0007",50,28,22
"6154",6154,420,1737,2988,2198,"0008",100,69,31
"6155",6155,169,558,1018,739,"0009",1090,498,592
"6156",6156,335,1291,2484,1657,"0010",558,314,244
"6157",6157,42,309,472,356,"0011",1352,215,1137
"6158",6158,195,937,1571,1171,"0012",136,102,34
"6159",6159,79,327,592,412,"0013",557,436,121
"6160",6160,556,1553,3661,2151,"0014",1049,664,385
"6161",6161,651,1911,4163,2615,"0101",301,255,46
"6162",6162,702,2381,4120,3149,"0102",724,658,66
"6163",6163,318,549,1772,904,"0108",944,861,83
"6164",6164,189,994,1724,1196,"0109",3105,2826,279
"6165",6165,688,1671,4259,2428,"0203",2635,2226,409
"6166",6166,251,1520,2493,1795,"0204",930,839,91
"6167",6167,413,1620,3171,2065,"0205",819,732,87
"6168",6168,229,724,1624,983,"0307",4443,3473,970
"6169",6169,159,1014,1544,1185,"0410",4212,3589,623
"6170",6170,230,1551,2419,1805,"0001",17,15,2
"6171",6171,272,1166,2020,1463,"0002",1,1,0
"6172",6172,166,754,1331,938,"0003",20,19,1
"6173",6173,237,1574,2364,1846,"0004",2,1,1
"6174",6174,186,869,1538,1075,"0001",5242,1767,3475
"6175",6175,517,1862,3494,2410,"0002A",2662,836,1826
"6176",6176,386,1632,3113,2055,"0002B",0,0,0
"6177",6177,411,1150,2385,1587,"0003",4433,777,3656
"6178",6178,631,2416,4219,3086,"0004",1665,154,1511
"6179",6179,195,438,1298,644,"0005",1760,434,1326
"6180",6180,262,885,1524,1169,"0006A",1875,119,1756
"6181",6181,134,513,1020,660,"0006B",0,0,0
"6182",6182,418,1256,2480,1702,"0007",2724,1777,947
"6183",6183,522,1410,3159,1979,"0008",4182,2300,1882
"6184",6184,743,2471,4408,3273,"0009",2799,2128,671
"6185",6185,731,1089,2780,1856,"0010",1966,872,1094
"6186",6186,665,986,2515,1677,"0012",2030,1472,558
"6187",6187,267,1048,2030,1333,"0013",2637,1581,1056
"6188",6188,296,1356,2440,1675,"0014",1628,941,687
"6189",6189,185,1733,2672,1945,"0015",1955,1533,422
"6190",6190,251,1523,2481,1794,"0016",1480,1048,432
"6191",6191,265,665,1643,938,"0017",1694,652,1042
"6192",6192,15,117,164,132,"0018",1933,930,1003
"6193",6193,5,108,148,115,"0019",4087,592,3495
"6194",6194,207,506,1216,726,"0020",1722,90,1632
"6195",6195,134,347,874,482,"0021",2984,1385,1599
"6196",6196,7,203,251,214,"0022",2501,1390,1111
"6197",6197,59,451,639,514,"0023",1659,1094,565
"6198",6198,25,116,184,142,"0024",3041,1397,1644
"6199",6199,18,133,212,153,"0025",3039,728,2311
"6200",6200,19,228,305,248,"0026",4195,650,3545
"6201",6201,123,382,774,510,"0027",5526,2353,3173
"6202",6202,79,304,623,386,"0028",3306,1945,1361
"6203",6203,2,28,45,30,"0029",3299,942,2357
"6204",6204,253,331,1106,589,"0030",3805,2008,1797
"6205",6205,23,49,141,75,"0031A",1889,1286,603
"6206",6206,687,1301,3295,2011,"0031B",0,0,0
"6207",6207,198,772,1453,982,"0033",4316,2852,1464
"6208",6208,676,1351,2629,2060,"0034",1650,772,878
"6209",6209,401,1157,2097,1581,"0035",710,521,189
"6210",6210,879,367,2253,1268,"0036",2714,1539,1175
"6211",6211,246,1245,2132,1515,"0038",2135,649,1486
"6212",6212,982,1050,2885,2068,"0039",2122,1581,541
"6213",6213,483,797,2064,1303,"0040",1526,114,1412
"6214",6214,280,1015,1921,1316,"0041",2544,1587,957
"6215",6215,260,1543,2548,1820,"0043",659,457,202
"6216",6216,434,1004,2079,1474,"0044",1710,1101,609
"6217",6217,219,1157,2041,1393,"0045",522,288,234
"6218",6218,1060,1209,3302,2308,"0046",3436,2390,1046
"6219",6219,996,1128,2775,2163,"0047",3549,1985,1564
"6220",6220,281,1595,2931,1905,"0049",375,59,316
"6221",6221,300,1755,3096,2073,"0050",6183,605,5578
"6222",6222,219,1136,1844,1374,"0051",252,128,124
"6223",6223,326,1454,2490,1809,"0052",5834,3636,2198
"6224",6224,500,1140,2476,1673,"0053",5205,2436,2769
"6225",6225,245,807,1642,1073,"0054",3094,2545,549
"6226",6226,292,1354,2653,1671,"0056",771,476,295
"6227",6227,139,757,1208,915,"0057A",5063,3014,2049
"6228",6228,306,706,1570,1030,"0057B",10,6,4
"6229",6229,268,704,1441,983,"0058",1937,1282,655
"6230",6230,213,375,977,600,"0059",4259,2107,2152
"6231",6231,662,231,1880,913,"0060",1166,912,254
"6232",6232,786,1493,3077,2330,"0062",2947,1949,998
"6233",6233,225,854,1639,1098,"0063",294,151,143
"6234",6234,1003,727,2444,1765,"0065",1647,842,805
"6235",6235,279,1067,2010,1360,"0066",2658,2053,605
"6236",6236,303,577,1190,899,"0067",2878,1535,1343
"6237",6237,613,1240,2420,1888,"0072",3881,2040,1841
"6238",6238,176,201,551,385,"0075",1192,940,252
"6239",6239,492,1420,2572,1940,"0076",2528,1435,1093
"6240",6240,1334,1424,3904,2798,"0078",3120,2310,810
"6241",6241,808,906,2250,1749,"0092A",544,347,197
"6242",6242,834,605,2018,1464,"0092B",22,7,15
"6243",6243,525,1260,2548,1816,"0096",0,0,0
"6244",6244,55,176,292,235,"0102",627,513,114
"6245",6245,493,1635,2724,2172,"0104",1165,814,351
"6246",6246,434,1433,2394,1902,"0109",3692,2895,797
"6247",6247,335,1614,2354,1981,"0110",3655,2968,687
"6248",6248,378,1211,1981,1615,"0111",2260,1586,674
"6249",6249,391,1281,2111,1701,"0112",232,181,51
"6250",6250,407,1291,2113,1730,"0113A",3676,1714,1962
"6251",6251,410,1313,2202,1753,"0113B",0,0,0
"6252",6252,359,1535,2345,1925,"0114",1010,278,732
"6253",6253,182,587,1041,787,"0118",2284,1103,1181
"6254",6254,409,1285,2306,1732,"0119",3956,1695,2261
"6255",6255,108,501,759,612,"0120",4173,2640,1533
"6256",6256,520,1507,2791,2063,"0121",3389,2414,975
"6257",6257,276,1005,1655,1305,"0122",1265,851,414
"6258",6258,228,751,1282,1000,"0123",2136,1495,641
"6259",6259,510,1698,2833,2247,"0124",1939,1406,533
"6260",6260,14,28,64,43,"0125",2298,1628,670
"6261",6261,17,32,87,55,"0126",2039,1251,788
"6262",6262,16,24,58,46,"0127",3200,2219,981
"6263",6263,2,31,39,34,"0128",1860,1516,344
"6264",6264,5,3,16,12,"0129",4011,2580,1431
"6265",6265,11,9,28,21,"0135",379,263,116
"6266",6266,13,133,189,148,"0138",532,376,156
"6267",6267,4,26,36,30,"0140",4635,3367,1268
"6268",6268,6,70,97,76,"0141",3301,1839,1462
"6269",6269,5,61,93,67,"0142",210,125,85
"6270",6270,1,33,50,37,"0151",1151,796,355
"6271",6271,18,85,130,104,"0152",2615,1580,1035
"6272",6272,468,1760,2937,2263,"0153",1895,133,1762
"6273",6273,149,667,1118,832,"0154",4200,2642,1558
"6274",6274,251,1014,1613,1286,"0155",2252,1831,421
"6275",6275,293,790,1391,1108,"0159",57,18,39
"6276",6276,115,231,556,353,"0178",277,221,56
"6277",6277,499,1103,2291,1631,"0001A",340,160,180
"6278",6278,274,1312,2168,1610,"0001B",51,34,17
"6279",6279,226,515,1176,759,"0002",433,205,228
"6280",6280,508,1816,3277,2362,"0003",562,234,328
"6281",6281,477,1644,2527,2160,"0004",686,518,168
"6282",6282,264,882,1475,1168,"0005",63,35,28
"6283",6283,167,509,930,681,"0006",455,256,199
"6284",6284,733,1682,3571,2469,"0007",41,25,16
"6285",6285,579,998,2781,1616,"0008",83,52,31
"6286",6286,106,725,1070,842,"0009",343,248,95
"6287",6287,338,1035,1684,1392,"0010",22,17,5
"6288",6288,485,1866,3183,2380,"0011",82,55,27
"6289",6289,20,229,303,252,"0012",262,96,166
"6290",6290,248,1054,1803,1325,"0013",172,143,29
"6291",6291,324,1047,1795,1400,"0014",413,123,290
"6292",6292,86,474,729,561,"0101",1456,1176,280
"6293",6293,43,256,471,302,"0102",177,108,69
"6294",6294,23,183,263,210,"0201",1356,567,789
"6295",6295,32,272,460,307,"0202",105,93,12
"6296",6296,23,224,323,248,"0301",1260,896,364
"6297",6297,26,256,349,285,"0302",276,224,52
"6298",6298,51,322,507,379,"0401",881,590,291
"6299",6299,1,46,55,47,"0402",324,283,41
"6300",6300,0,25,30,25,"0403",150,141,9
"6301",6301,2,41,47,43,"0001",658,291,367
"6302",6302,5,39,50,44,"0002",1046,314,732
"6303",6303,100,299,520,407,"0003",10060,5976,4084
"6304",6304,113,260,569,382,"0004",136,85,51
"6305",6305,135,222,563,368,"0005",1678,130,1548
"6306",6306,98,363,611,471,"0006",1684,175,1509
"6307",6307,237,185,725,432,"0007",2539,715,1824
"6308",6308,486,843,2045,1355,"0008",1966,781,1185
"6309",6309,219,155,698,379,"0009",1748,393,1355
"6310",6310,454,441,1452,914,"0010",3614,461,3153
"6311",6311,410,571,1569,1008,"0011",2122,1611,511
"6312",6312,221,207,769,442,"0012",4163,445,3718
"6313",6313,136,134,460,274,"0013",39,34,5
"6314",6314,404,337,1296,757,"0014",3058,747,2311
"6315",6315,541,565,1871,1131,"0015",296,192,104
"6316",6316,199,191,687,399,"0016",961,645,316
"6317",6317,98,106,350,212,"0017",1274,632,642
"6318",6318,228,490,1060,730,"0018",1702,994,708
"6319",6319,268,429,1140,705,"0019",3307,2423,884
"6320",6320,387,275,1252,672,"0020",950,378,572
"6321",6321,368,209,1189,592,"0021",2071,1206,865
"6322",6322,559,286,1576,862,"0022",822,245,577
"6323",6323,166,151,553,322,"0023",3039,2557,482
"6324",6324,75,314,630,395,"0024",973,631,342
"6325",6325,20,109,220,129,"0025",3177,776,2401
"6326",6326,35,180,357,215,"0026",1437,554,883
"6327",6327,59,258,524,321,"0027",1802,389,1413
"6328",6328,7,27,56,34,"0028",1406,747,659
"6329",6329,69,292,595,362,"0029",1648,639,1009
"6330",6330,29,245,319,278,"0030",2721,1359,1362
"6331",6331,72,485,816,566,"0031",3286,1703,1583
"6332",6332,86,883,1380,982,"0032",1300,1007,293
"6333",6333,42,422,592,465,"0033",1683,1228,455
"6334",6334,24,229,332,256,"0034",1507,1140,367
"6335",6335,82,370,673,458,"0035",1744,472,1272
"6336",6336,58,371,608,435,"0036",1008,810,198
"6337",6337,18,139,236,157,"0037",1555,579,976
"6338",6338,76,424,714,504,"0038",1056,415,641
"6339",6339,58,529,846,589,"0039",2033,283,1750
"6340",6340,71,845,1218,922,"0040",2457,1630,827
"6341",6341,49,388,548,440,"0041",2353,1407,946
"6342",6342,51,360,567,423,"0042",1887,478,1409
"6343",6343,116,834,1320,964,"0043",1008,621,387
"6344",6344,129,909,1818,1058,"0044",6025,4490,1535
"6345",6345,66,928,1538,1001,"0045",861,422,439
"6346",6346,118,958,1072,1090,"0046",616,123,493
"6347",6347,177,1098,1790,1292,"0047",467,258,209
"6348",6348,106,623,956,738,"0048",1126,273,853
"6349",6349,12,73,113,87,"0049",742,262,480
"6350",6350,675,1895,3949,2609,"0050",2848,1107,1741
"6351",6351,168,220,807,391,"0051",6068,3902,2166
"6352",6352,408,195,1255,612,"0052",853,785,68
"6353",6353,878,1005,4047,1915,"0053A",1642,996,646
"6354",6354,441,957,2213,1428,"0053B",0,0,0
"6355",6355,173,394,1019,571,"0054",735,536,199
"6356",6356,237,919,1605,1179,"0055",1356,1109,247
"6357",6357,92,425,1005,522,"0056",1339,376,963
"6358",6358,119,226,903,354,"0057",2238,1104,1134
"6359",6359,67,366,752,444,"0058",5020,2448,2572
"6360",6360,8,71,81,80,"0059",4124,3144,980
"6361",6361,37,254,487,298,"0060",5864,3867,1997
"6362",6362,51,162,469,219,"0061",3587,2366,1221
"6363",6363,216,919,2042,1159,"0062",7759,5179,2580
"6364",6364,143,428,1039,578,"0063",4197,3449,748
"6365",6365,47,193,410,248,"0064",1568,1074,494
"6366",6366,50,372,709,428,"0065",1552,1236,316
"6367",6367,10,105,170,115,"0066",1563,1324,239
"6368",6368,419,1047,2117,1497,"0067",3355,2860,495
"6369",6369,435,2045,3559,2516,"0068",1333,1093,240
"6370",6370,293,953,2224,1277,"0069",1908,1569,339
"6371",6371,179,760,1382,961,"0070",509,376,133
"6372",6372,63,418,597,485,"0071",1001,672,329
"6373",6373,51,349,531,410,"0072",1100,828,272
"6374",6374,87,482,898,585,"0073",1199,1000,199
"6375",6375,328,1056,2156,1414,"0074",858,658,200
"6376",6376,289,976,1932,1286,"0075",3391,2825,566
"6377",6377,306,461,1224,794,"0076",2999,2278,721
"6378",6378,137,151,661,291,"0077",2103,1564,539
"6379",6379,265,264,1070,539,"0078",4164,2842,1322
"6380",6380,2,60,92,62,"0079",2211,1257,954
"6381",6381,217,259,924,483,"0080",2446,2114,332
"6382",6382,125,140,465,270,"0081",4575,3864,711
"6383",6383,119,954,1378,1084,"0082",2975,2433,542
"6384",6384,187,926,1508,1123,"0083",639,504,135
"6385",6385,70,513,776,584,"0084",2663,2075,588
"6386",6386,66,508,732,585,"0085",1150,463,687
"6387",6387,105,839,1250,953,"0086",2882,1199,1683
"6388",6388,155,1005,1486,1175,"0087",3173,1112,2061
"6389",6389,150,918,1416,1082,"0088",1046,440,606
"6390",6390,74,488,785,564,"0089",147,16,131
"6391",6391,133,983,1452,1128,"0090",561,326,235
"6392",6392,56,586,777,647,"0091",1879,1553,326
"6393",6393,218,1084,2062,1317,"0001",143,70,73
"6394",6394,329,855,1861,1193,"0003",130,99,31
"6395",6395,95,109,304,205,"002A",34,21,13
"6396",6396,18,181,253,201,"002B",67,31,36
"6397",6397,28,427,562,459,"004A",56,34,22
"6398",6398,251,1099,1886,1371,"004B",57,33,24
"6399",6399,45,278,407,325,"0101",4345,1649,2696
"6400",6400,14,100,145,117,"0202",2160,1401,759
"6401",6401,181,752,1243,955,"0303",2092,949,1143
"6402",6402,38,158,241,201,"0404",2104,1707,397
"6403",6403,227,761,1326,1002,"0001",732,532,200
"6404",6404,142,425,807,578,"0002",1475,1225,250
"6405",6405,70,55,181,128,"0003",644,490,154
"6406",6406,49,191,299,243,"0004",530,354,176
"6407",6407,155,347,791,509,"0005",745,559,186
"6408",6408,108,517,815,635,"0006",1012,656,356
"6409",6409,190,1093,1785,1302,"0007",864,423,441
"6410",6410,34,258,371,295,"0008",874,706,168
"6411",6411,53,420,632,478,"0009",491,403,88
"6412",6412,83,600,941,695,"0010",649,516,133
"6413",6413,46,395,549,446,"0001A",1083,550,533
"6414",6414,96,826,1149,930,"0001B",0,0,0
"6415",6415,31,424,607,459,"0002",792,284,508
"6416",6416,99,703,1136,812,"0003A",769,520,249
"6417",6417,20,305,436,327,"0003B",0,0,0
"6418",6418,57,740,1084,813,"0004",614,380,234
"6419",6419,101,568,1036,682,"003A",223,180,43
"6420",6420,157,431,833,605,"004A",215,153,62
"6421",6421,69,589,835,668,"0101",798,643,155
"6422",6422,36,171,290,210,"0210",678,417,261
"6423",6423,124,672,1246,804,"0302",851,727,124
"6424",6424,79,746,1184,830,"0405",875,695,180
"6425",6425,195,1740,2650,1952,"0002",691,600,91
"6426",6426,60,328,567,392,"0004",1594,1024,570
"6427",6427,53,589,994,648,"0005",2251,1342,909
"6428",6428,237,549,1411,794,"0006",1479,1139,340
"6429",6429,184,1765,2847,1966,"0007",255,192,63
"6430",6430,176,1853,3026,2045,"0008",940,545,395
"6431",6431,495,1874,3791,2387,"0009",142,82,60
"6432",6432,233,308,812,541,"0010",401,313,88
"6433",6433,43,624,1059,671,"0012",376,189,187
"6434",6434,493,258,1306,756,"0013",360,240,120
"6435",6435,582,2006,4037,2620,"001A",2897,1562,1335
"6436",6436,745,1078,3545,1847,"001B",4472,2153,2319
"6437",6437,290,2114,3468,2425,"001C",1137,229,908
"6438",6438,478,1496,3403,1989,"001D",2500,621,1879
"6439",6439,140,341,927,485,"001E",2332,798,1534
"6440",6440,253,1549,2893,1815,"001F",1287,381,906
"6441",6441,62,720,1204,786,"003A",3129,842,2287
"6442",6442,240,1141,2506,1395,"003B",904,484,420
"6443",6443,308,897,1854,1210,"001A",994,25,969
"6444",6444,315,654,1812,977,"001B",2757,115,2642
"6445",6445,272,868,1790,1147,"001C",6460,108,6352
"6446",6446,35,444,662,481,"002A",887,21,866
"6447",6447,68,431,702,504,"002BA",1024,157,867
"6448",6448,70,498,732,572,"002BB",660,16,644
"6449",6449,170,231,766,415,"002BC",3230,36,3194
"6450",6450,298,136,887,439,"002C",4437,64,4373
"6451",6451,47,28,131,75,"002D",119,9,110
"6452",6452,75,312,526,390,"003A",3629,153,3476
"6453",6453,111,221,538,339,"003B",5595,148,5447
"6454",6454,40,241,398,284,"003C",716,117,599
"6455",6455,219,682,1458,912,"004A",1336,50,1286
"6456",6456,101,298,643,404,"004B",3404,155,3249
"6457",6457,13,134,219,149,"004C",1662,34,1628
"6458",6458,82,425,754,509,"004D",4019,27,3992
"6459",6459,70,210,383,283,"001A",1324,1006,318
"6460",6460,385,476,1589,873,"001B",1742,1291,451
"6461",6461,37,309,476,347,"001C",3115,1814,1301
"6462",6462,33,204,353,240,"001D",2974,1599,1375
"6463",6463,42,286,417,329,"002A",2821,1153,1668
"6464",6464,26,231,360,260,"002B",3193,1993,1200
"6465",6465,19,124,181,145,"002C",5015,2465,2550
"6466",6466,25,189,340,219,"003A",1085,700,385
"6467",6467,8,87,122,97,"003B",648,329,319
"6468",6468,16,233,361,252,"003C",3418,1359,2059
"6469",6469,0,3,4,3,"003D",4806,1022,3784
"6470",6470,26,278,438,306,"004A",2044,1052,992
"6471",6471,19,114,185,134,"004B",4561,1969,2592
"6472",6472,30,228,387,264,"004C",2225,555,1670
"6473",6473,7,73,135,83,"0001",350,142,208
"6474",6474,60,287,497,350,"0002",383,246,137
"6475",6475,126,610,1043,743,"0003",452,345,107
"6476",6476,169,455,1122,630,"0004",256,162,94
"6477",6477,72,458,761,533,"0005",71,65,6
"6478",6478,33,273,383,307,"0006",90,83,7
"6479",6479,15,146,221,162,"0101A",1392,698,694
"6480",6480,3,20,43,23,"0101B",0,0,0
"6481",6481,5,101,137,106,"0102",5277,2436,2841
"6482",6482,155,568,1292,738,"0103",3668,1946,1722
"6483",6483,32,219,389,255,"0104",1681,460,1221
"6484",6484,5,60,90,66,"0105",2859,923,1936
"6485",6485,15,110,166,126,"0106A",4,1,3
"6486",6486,44,343,516,389,"0106B",5252,2003,3249
"6487",6487,86,551,912,640,"0107",4070,2373,1697
"6488",6488,41,165,264,211,"0108A",1252,590,662
"6489",6489,115,380,594,505,"0108B",0,0,0
"6490",6490,198,610,999,822,"0108C",0,0,0
"6491",6491,560,2246,3405,2837,"0109A",1290,350,940
"6492",6492,324,1466,2518,1818,"0109B",0,0,0
"6493",6493,136,540,850,689,"0110",3041,2296,745
"6494",6494,108,454,758,578,"0201",4202,1800,2402
"6495",6495,439,1728,3269,2196,"0202",7194,4492,2702
"6496",6496,544,2490,3999,3084,"0203",1141,516,625
"6497",6497,0,16,28,16,"0204",3177,2398,779
"6498",6498,1,13,24,15,"0205",973,774,199
"6499",6499,2,22,41,24,"0206",2033,1533,500
"6500",6500,1,9,18,11,"0207",3415,2055,1360
"6501",6501,1002,740,3327,1767,"0208",1358,550,808
"6502",6502,491,615,2041,1119,"0210",1984,1080,904
"6503",6503,848,381,2874,1251,"0211",5710,3041,2669
"6504",6504,332,122,1235,460,"0212",2141,1052,1089
"6505",6505,278,142,730,428,"0302",6210,1829,4381
"6506",6506,583,67,1625,654,"0303",608,112,496
"6507",6507,567,1326,2877,1931,"0304",4090,504,3586
"6508",6508,1140,666,2726,1847,"0305",2734,230,2504
"6509",6509,654,1094,2453,1785,"0306",3115,216,2899
"6510",6510,331,214,1283,559,"0307",1579,750,829
"6511",6511,58,68,226,126,"0308",6929,1056,5873
"6512",6512,468,907,1839,1395,"0309",1162,232,930
"6513",6513,198,325,836,537,"0310",1117,327,790
"6514",6514,433,557,1635,1010,"0401A",1535,993,542
"6515",6515,1051,911,2885,2011,"0401B",0,0,0
"6516",6516,915,647,3239,1610,"0402",416,302,114
"6517",6517,330,181,1455,518,"0403",3622,2571,1051
"6518",6518,522,46,1249,572,"0404",3029,1972,1057
"6519",6519,509,634,2151,1171,"0405",3505,2035,1470
"6520",6520,655,1061,2767,1750,"0406",2963,1755,1208
"6521",6521,415,556,1387,996,"0407",4526,2342,2184
"6522",6522,503,549,1983,1076,"0408",2141,1598,543
"6523",6523,265,196,1069,472,"0409",3047,1714,1333
"6524",6524,657,516,2895,1198,"0410",1631,1207,424
"6525",6525,789,937,3314,1758,"0411",4153,3244,909
"6526",6526,492,870,2010,1398,"108A",649,329,320
"6527",6527,741,662,3146,1426,"109AA",19,6,13
"6528",6528,553,954,2385,1537,"109AB",0,0,0
"6529",6529,203,907,1610,1126,"307A",336,169,167
"6530",6530,177,531,988,720,"309A",136,71,65
"6531",6531,327,1870,3129,2226,"402A",768,582,186
"6532",6532,66,297,653,366,"0101",3086,1992,1094
"6533",6533,117,524,878,652,"0105",1424,1034,390
"6534",6534,371,939,2178,1326,"0203",469,372,97
"6535",6535,128,520,789,653,"0207",870,482,388
"6536",6536,349,495,1651,853,"0210",628,467,161
"6537",6537,204,1092,1724,1312,"0212",2827,1385,1442
"6538",6538,370,69,1210,448,"0316",806,609,197
"6539",6539,327,1363,2409,1719,"0317",1195,1019,176
"6540",6540,64,384,708,462,"0318",2912,1977,935
"6541",6541,167,675,1301,854,"0419",2488,1533,955
"6542",6542,57,225,426,286,"0420",2365,1829,536
"6543",6543,301,1841,2958,2175,"0001",924,743,181
"6544",6544,640,1055,2679,1738,"0002",647,495,152
"6545",6545,417,340,1195,764,"0004",317,263,54
"6546",6546,422,370,1263,805,"0006",220,176,44
"6547",6547,29,66,187,97,"0008",586,529,57
"6548",6548,547,1413,2689,1981,"0009",674,509,165
"6549",6549,735,1059,3185,1838,"0011",201,180,21
"6550",6550,581,1848,3101,2451,"0001",1289,802,487
"6551",6551,133,546,1022,685,"0002",227,178,49
"6552",6552,466,889,2009,1381,"0003",1286,863,423
"6553",6553,287,671,1374,978,"0004",639,342,297
"6554",6554,670,1002,2866,1712,"0025",3174,1021,2153
"6555",6555,270,666,1192,950,"0046",600,357,243
"6556",6556,489,1132,2386,1655,"0002",2768,2313,455
"6557",6557,26,63,178,89,"0003",1481,1328,153
"6558",6558,170,468,1222,646,"0004",839,677,162
"6559",6559,462,1471,2446,1959,"0005",1123,932,191
"6560",6560,466,916,2185,1401,"0006",1089,904,185
"6561",6561,649,1165,2870,1856,"0007",1038,909,129
"6562",6562,218,686,1159,918,"0008",855,766,89
"6563",6563,442,932,1984,1388,"0009",1329,1211,118
"6564",6564,589,1915,3048,2531,"0010",1319,1001,318
"6565",6565,62,187,413,253,"0011",1308,1028,280
"6566",6566,31,297,431,333,"0012",179,138,41
"6567",6567,49,298,479,349,"0013",1002,862,140
"6568",6568,185,625,1020,828,"0014",268,237,31
"6569",6569,213,561,1068,782,"0015",614,531,83
"6570",6570,458,1832,2773,2309,"0016",340,297,43
"6571",6571,621,2342,3543,2991,"0001",3075,1419,1656
"6572",6572,336,1237,1994,1596,"0002",3613,1888,1725
"6573",6573,379,785,1681,1190,"0003",7800,4392,3408
"6574",6574,765,900,2565,1692,"0004",2627,1681,946
"6575",6575,265,179,805,450,"0005",340,299,41
"6576",6576,401,701,1738,1114,"0006",4292,2681,1611
"6577",6577,753,1046,2993,1835,"0007",2585,1720,865
"6578",6578,388,1928,3445,2346,"0008",3634,2796,838
"6579",6579,441,1966,3187,2438,"0009",2087,1599,488
"6580",6580,434,766,1764,1221,"0010",4991,658,4333
"6581",6581,424,890,1827,1347,"0011",2871,2029,842
"6582",6582,364,1087,1901,1475,"0012",4301,1761,2540
"6583",6583,428,1152,2096,1608,"0013",6149,4651,1498
"6584",6584,319,602,1373,947,"0014",6437,2890,3547
"6585",6585,530,1378,2664,1929,"0015",5393,4024,1369
"6586",6586,333,1107,1822,1457,"0016",5495,3651,1844
"6587",6587,661,1718,3302,2417,"0017",5453,3511,1942
"6588",6588,87,278,477,373,"0018",6418,4184,2234
"6589",6589,30,262,408,297,"0019",4329,3416,913
"6590",6590,301,1011,1685,1328,"0020",3951,1228,2723
"6591",6591,425,1417,2372,1868,"0021",6071,3559,2512
"6592",6592,643,1143,2743,1817,"0022",5973,4465,1508
"6593",6593,37,55,154,92,"0023",5705,3081,2624
"6594",6594,113,522,937,641,"0024",3755,2308,1447
"6595",6595,438,525,1431,980,"0025",5610,3352,2258
"6596",6596,506,123,1634,636,"0026",4804,2287,2517
"6597",6597,591,1839,3460,2468,"0027",5530,3442,2088
"6598",6598,258,1562,2257,1835,"0028",4094,2831,1263
"6599",6599,32,191,284,226,"0029",5483,4360,1123
"6600",6600,109,276,880,390,"0030",2957,2371,586
"6601",6601,60,255,546,321,"0031",4942,3619,1323
"6602",6602,66,244,643,313,"0032",3785,2285,1500
"6603",6603,62,599,875,671,"0033",3955,2922,1033
"6604",6604,4,26,63,30,"0034",2780,2076,704
"6605",6605,67,194,461,264,"0035",6850,3768,3082
"6606",6606,9,27,61,37,"0036",4762,2884,1878
"6607",6607,52,232,487,286,"0037",4395,2523,1872
"6608",6608,109,789,1303,906,"0038",6202,5183,1019
"6609",6609,15,107,191,123,"0039",5363,4401,962
"6610",6610,121,418,1040,548,"0040",7266,5181,2085
"6611",6611,18,102,139,121,"0041",5063,3592,1471
"6612",6612,115,586,1135,711,"0042",1248,854,394
"6613",6613,14,179,228,194,"0043",6016,4648,1368
"6614",6614,59,384,820,453,"0044",4138,2134,2004
"6615",6615,25,240,346,267,"0045",2902,2014,888
"6616",6616,14,99,141,114,"0046",6754,3773,2981
"6617",6617,123,71,424,206,"0047",5259,2764,2495
"6618",6618,169,78,641,255,"0048",2577,2070,507
"6619",6619,1021,637,2983,1733,"0049",2417,1770,647
"6620",6620,43,41,217,86,"0050",4179,3478,701
"6621",6621,306,115,1039,434,"0051",4984,1937,3047
"6622",6622,302,106,956,424,"0052",6889,3547,3342
"6623",6623,579,279,1741,896,"0053",5727,3485,2242
"6624",6624,519,288,1365,839,"0054",3491,1393,2098
"6625",6625,373,132,1046,517,"0055",2692,1277,1415
"6626",6626,871,131,2353,1034,"0056",3468,2244,1224
"6627",6627,590,1051,2144,1694,"0057",3424,2724,700
"6628",6628,1515,117,3306,1679,"0058",2273,1922,351
"6629",6629,35,44,153,81,"0059",1611,1270,341
"6630",6630,642,79,1567,750,"0060",6639,2074,4565
"6631",6631,54,123,264,180,"0061",4790,3457,1333
"6632",6632,658,1239,2829,1948,"0062",2784,2148,636
"6633",6633,375,359,1095,755,"0063",6041,5124,917
"6634",6634,235,132,642,384,"0064",3456,1683,1773
"6635",6635,753,1498,3074,2325,"0065",6519,4520,1999
"6636",6636,167,72,534,249,"0066",5282,3507,1775
"6637",6637,259,138,663,412,"0067",3298,2292,1006
"6638",6638,160,94,503,266,"0068",5684,3540,2144
"6639",6639,843,1772,3322,2698,"0069",4340,3178,1162
"6640",6640,166,388,818,566,"0070",2658,1993,665
"6641",6641,605,322,1969,956,"0071",4435,3193,1242
"6642",6642,235,165,766,408,"0072",4006,3555,451
"6643",6643,376,104,1132,495,"0073",2250,1413,837
"6644",6644,375,361,1126,769,"0074",3976,2102,1874
"6645",6645,289,218,936,520,"0075",5681,3780,1901
"6646",6646,642,591,2028,1272,"0076",5832,4472,1360
"6647",6647,720,763,2455,1530,"0077",4506,3915,591
"6648",6648,236,439,921,700,"0078",5213,3615,1598
"6649",6649,480,705,1601,1226,"0079",2716,1870,846
"6650",6650,421,592,1390,1042,"0080",5992,3974,2018
"6651",6651,365,201,1130,585,"0081",4788,3421,1367
"6652",6652,337,482,1004,846,"0082",6901,4384,2517
"6653",6653,346,259,1120,629,"0083",2001,1436,565
"6654",6654,242,168,701,432,"0084",7886,3579,4307
"6655",6655,329,95,1073,443,"0085",4929,3205,1724
"6656",6656,632,794,2014,1469,"0086",3087,2194,893
"6657",6657,503,564,1662,1105,"0087",4343,2805,1538
"6658",6658,428,205,1275,649,"0088",4812,2724,2088
"6659",6659,152,153,538,324,"0089",5178,3866,1312
"6660",6660,715,1807,3576,2595,"0090",5927,4797,1130
"6661",6661,184,122,544,313,"0091",2357,1791,566
"6662",6662,92,55,333,153,"0092",5541,3054,2487
"6663",6663,164,125,468,305,"0093",7237,3434,3803
"6664",6664,152,91,571,247,"0094",3442,1745,1697
"6665",6665,148,137,488,292,"0095",6440,3526,2914
"6666",6666,469,336,1608,824,"0096",8072,4075,3997
"6667",6667,1248,2022,4753,3371,"0097",3216,2684,532
"6668",6668,276,429,886,714,"0098",6449,3909,2540
"6669",6669,69,65,544,141,"0099",3646,3002,644
"6670",6670,0,0,0,0,"0100",4739,2872,1867
"6671",6671,499,1239,2465,1782,"0101",3868,1338,2530
"6672",6672,832,1780,3612,2701,"0201",2134,1055,1079
"6673",6673,249,168,941,430,"0202",1878,1033,845
"6674",6674,453,414,1435,887,"0203",108,73,35
"6675",6675,823,1009,3497,1871,"0301",3459,839,2620
"6676",6676,687,2131,3837,2875,"0401",1312,717,595
"6677",6677,771,1405,3160,2234,"0402",2185,91,2094
"6678",6678,844,1647,3489,2556,"0101",910,311,599
"6679",6679,967,1518,3438,2574,"0102",389,169,220
"6680",6680,978,2491,4298,3556,"0103",760,448,312
"6681",6681,189,493,1147,696,"0202",1087,953,134
"6682",6682,143,732,1267,882,"0203",1189,777,412
"6683",6683,154,864,1366,1031,"0302",1279,846,433
"6684",6684,335,1702,2845,2078,"0303",1265,1043,222
"6685",6685,162,713,1175,886,"0401",2421,1755,666
"6686",6686,163,1078,1779,1260,"0001",220,183,37
"6687",6687,41,253,420,299,"0002",84,71,13
"6688",6688,159,354,884,531,"0003",21,17,4
"6689",6689,179,539,1031,730,"0004",219,203,16
"6690",6690,109,618,1018,737,"0005",119,92,27
"6691",6691,103,481,801,591,"0006",178,139,39
"6692",6692,483,2065,3347,2582,"0012",2317,1861,456
"6693",6693,322,1286,2500,1656,"0013",1415,1162,253
"6694",6694,182,976,1766,1181,"0014",3472,2587,885
"6695",6695,659,1912,3646,2632,"0015",1989,1480,509
"6696",6696,281,634,1521,946,"0016",2737,2229,508
"6697",6697,183,1596,2350,1832,"0017",895,563,332
"6698",6698,0,0,0,0,"0021",2557,1502,1055
"6699",6699,552,2518,4071,3133,"0022",191,119,72
"6700",6700,414,1675,2884,2123,"0023",384,249,135
"6701",6701,86,363,650,459,"0024",2117,864,1253
"6702",6702,418,1124,2134,1574,"0025",98,68,30
"6703",6703,296,240,932,558,"0026",5193,2041,3152
"6704",6704,720,457,2120,1199,"0027",1792,147,1645
"6705",6705,488,387,1866,900,"0030",902,408,494
"6706",6706,151,166,693,321,"0031",1020,693,327
"6707",6707,26,11,98,38,"0032",5724,3627,2097
"6708",6708,125,158,479,290,"0033",5780,4110,1670
"6709",6709,474,992,1870,1521,"0034",162,76,86
"6710",6710,11,85,134,99,"0041",1342,618,724
"6711",6711,16,140,209,158,"0042",3189,1167,2022
"6712",6712,13,106,153,120,"0043",1560,1052,508
"6713",6713,13,129,209,144,"0044",2146,1691,455
"6714",6714,223,947,1805,1176,"0045",906,743,163
"6715",6715,273,1108,2018,1386,"0046",1086,837,249
"6716",6716,433,732,1847,1175,"0047",1029,973,56
"6717",6717,159,1382,2136,1561,"0101",2852,1330,1522
"6718",6718,125,296,666,429,"0103",2132,1437,695
"6719",6719,134,635,1193,781,"0104",1066,614,452
"6720",6720,95,365,690,469,"0105",376,233,143
"6721",6721,106,198,444,310,"0106",797,366,431
"6722",6722,117,426,793,551,"0107",2211,903,1308
"6723",6723,185,408,967,605,"0108",591,368,223
"6724",6724,275,263,919,553,"0109",529,292,237
"6725",6725,151,478,894,638,"0200",1247,299,948
"6726",6726,59,214,457,281,"0201",995,133,862
"6727",6727,92,187,550,285,"0202",1855,229,1626
"6728",6728,88,454,918,548,"0203",2561,1640,921
"6729",6729,77,332,840,410,"0204",308,194,114
"6730",6730,56,460,715,517,"0205",1348,1187,161
"6731",6731,53,374,656,433,"0206",799,573,226
"6732",6732,7,91,129,101,"0300",4744,1935,2809
"6733",6733,7,146,206,153,"0301",491,227,264
"6734",6734,122,506,801,631,"0303",1401,1070,331
"6735",6735,111,482,773,601,"0304",788,645,143
"6736",6736,113,513,815,637,"0305",733,485,248
"6737",6737,111,490,769,605,"0306",381,241,140
"6738",6738,101,448,721,559,"0307",709,422,287
"6739",6739,123,820,1361,955,"0308",386,346,40
"6740",6740,334,1076,2017,1420,"0400",1863,1313,550
"6741",6741,209,753,1307,973,"0401",1035,431,604
"6742",6742,5,144,203,153,"0402",2739,1799,940
"6743",6743,114,479,914,606,"0403",1694,1409,285
"6744",6744,55,70,193,128,"0404",1339,943,396
"6745",6745,40,226,406,271,"0405",977,754,223
"6746",6746,28,160,291,189,"0406",301,256,45
"6747",6747,94,182,381,278,"0001",1203,942,261
"6748",6748,378,1390,2543,1793,"0002",367,299,68
"6749",6749,579,1408,3350,2024,"0003",579,539,40
"6750",6750,393,163,1041,568,"0004",149,121,28
"6751",6751,277,414,1523,705,"0005",511,447,64
"6752",6752,360,523,1597,900,"0006",784,419,365
"6753",6753,152,294,918,462,"0007",255,184,71
"6754",6754,386,810,2324,1213,"0008A",438,375,63
"6755",6755,105,485,860,604,"0008B",144,42,102
"6756",6756,484,326,1709,815,"0009",293,222,71
"6757",6757,533,397,1714,935,"0010",409,383,26
"6758",6758,1001,789,3772,1807,"0011",552,518,34
"6759",6759,309,238,1149,547,"0012",212,188,24
"6760",6760,186,152,798,341,"0013",1054,966,88
"6761",6761,497,458,2255,969,"0014",303,117,186
"6762",6762,572,540,3013,1120,"0015",436,360,76
"6763",6763,32,58,164,105,"0016",327,245,82
"6764",6764,247,214,1057,467,"0017",106,22,84
"6765",6765,1025,787,3427,1832,"0018",293,277,16
"6766",6766,1102,981,4595,2118,"0019",197,168,29
"6767",6767,127,210,576,341,"0020",160,32,128
"6768",6768,459,312,1981,781,"0021",432,382,50
"6769",6769,994,766,3113,1773,"0022",468,219,249
"6770",6770,158,106,566,266,"0001",1490,914,576
"6771",6771,600,547,3110,1157,"0002",1166,843,323
"6772",6772,373,1690,2713,2085,"0003",2321,1325,996
"6773",6773,1258,2354,4897,3672,"0004",2415,928,1487
"6774",6774,219,651,1303,882,"0005",124,119,5
"6775",6775,293,401,942,704,"0006",1236,760,476
"6776",6776,573,1742,3113,2334,"0007",290,249,41
"6777",6777,765,2019,4133,2815,"0008",159,143,16
"6778",6778,240,705,1282,950,"0009",1827,1312,515
"6779",6779,92,335,632,431,"0001",2313,1231,1082
"6780",6780,481,973,2404,1469,"0002",3301,1374,1927
"6781",6781,914,1254,4066,2185,"0003",3958,1435,2523
"6782",6782,22,106,162,128,"0004",3263,553,2710
"6783",6783,282,903,1866,1197,"0005",1800,938,862
"6784",6784,692,1624,3730,2337,"0006",3991,2192,1799
"6785",6785,569,885,2498,1468,"0007",1014,86,928
"6786",6786,57,161,353,221,"0008",6699,2586,4113
"6787",6787,48,194,344,246,"0009",2469,1024,1445
"6788",6788,42,217,373,261,"0010",1123,679,444
"6789",6789,35,135,230,173,"0011",718,190,528
"6790",6790,0,3,4,3,"0012",1425,186,1239
"6791",6791,5,42,62,47,"0013",1147,33,1114
"6792",6792,10,71,98,82,"0014",461,146,315
"6793",6793,71,518,1027,597,"0015",1428,325,1103
"6794",6794,436,1359,2765,1839,"0016",995,390,605
"6795",6795,515,1897,3780,2472,"0017",4562,1308,3254
"6796",6796,166,332,1117,511,"0018",4703,2603,2100
"6797",6797,280,789,1956,1092,"0019",2772,2411,361
"6798",6798,580,1604,3762,2233,"0020",4048,616,3432
"6799",6799,402,1532,2991,1970,"0021",531,287,244
"6800",6800,64,237,628,304,"0022",508,121,387
"6801",6801,0,0,0,0,"0023",2440,1543,897
"6802",6802,0,0,0,0,"0024",1256,163,1093
"6803",6803,158,263,845,434,"0025",716,324,392
"6804",6804,325,2066,3038,2422,"0026",4972,2040,2932
"6805",6805,236,1406,2735,1661,"0027",909,124,785
"6806",6806,143,1499,2363,1665,"0028",257,180,77
"6807",6807,79,436,763,525,"0029",3822,1548,2274
"6808",6808,499,2412,3906,2985,"0030",192,30,162
"6809",6809,261,928,1594,1218,"0031",1035,153,882
"6810",6810,238,1093,1783,1377,"0032",3310,1176,2134
"6811",6811,459,1519,2737,2017,"0033",2233,831,1402
"6812",6812,155,386,925,561,"0034",749,166,583
"6813",6813,241,792,1614,1058,"0035",984,50,934
"6814",6814,389,1652,2758,2080,"0036",915,171,744
"6815",6815,370,1488,3628,1894,"0037",1657,168,1489
"6816",6816,49,117,419,169,"0038",273,19,254
"6817",6817,283,367,1760,662,"0039",1063,374,689
"6818",6818,424,276,1630,717,"0040",4260,3347,913
"6819",6819,1018,770,3898,1840,"0041",643,24,619
"6820",6820,205,547,1192,761,"0042",457,276,181
"6821",6821,804,688,2805,1521,"0043",941,105,836
"6822",6822,42,119,404,165,"0044",1564,86,1478
"6823",6823,96,230,619,331,"0045",972,88,884
"6824",6824,76,741,1186,826,"0046",596,57,539
"6825",6825,127,697,1114,837,"0047",685,103,582
"6826",6826,391,2010,3284,2472,"0048",1731,459,1272
"6827",6827,330,1491,2505,1854,"0049",1422,628,794
"6828",6828,373,1463,2710,1870,"0050",710,200,510
"6829",6829,234,1169,2012,1434,"0051",3363,736,2627
"6830",6830,413,1480,3144,1938,"0052",995,99,896
"6831",6831,207,1620,2341,1852,"0053",1088,129,959
"6832",6832,296,1357,2466,1692,"0054",1543,136,1407
"6833",6833,133,1009,1443,1170,"0055",1011,54,957
"6834",6834,268,2097,2936,2402,"0056",1695,196,1499
"6835",6835,1,3,9,4,"0057",1074,187,887
"6836",6836,43,249,545,294,"0058",1270,692,578
"6837",6837,0,0,0,0,"0059",1867,751,1116
"6838",6838,217,2299,3614,2543,"0060",1457,58,1399
"6839",6839,231,601,1306,851,"0061",1272,44,1228
"6840",6840,1,16,30,17,"0062",1341,141,1200
"6841",6841,378,1318,2463,1716,"0063",2539,1476,1063
"6842",6842,139,655,1200,808,"0064",897,583,314
"6843",6843,52,223,384,277,"0065",4558,2001,2557
"6844",6844,125,257,624,385,"0066",2169,542,1627
"6845",6845,78,315,558,400,"0067",5787,2254,3533
"6846",6846,405,770,2040,1200,"0068",1436,191,1245
"6847",6847,103,386,677,493,"0069",2409,481,1928
"6848",6848,121,748,1179,875,"0070",4109,864,3245
"6849",6849,439,1206,2450,1670,"0071",2204,222,1982
"6850",6850,361,846,2023,1235,"0072",2120,356,1764
"6851",6851,295,1260,2188,1579,"0073",1815,182,1633
"6852",6852,76,593,901,673,"0074",2096,107,1989
"6853",6853,4,49,83,53,"0075",2758,130,2628
"6854",6854,54,448,712,503,"0076",1313,75,1238
"6855",6855,20,187,262,209,"0077",471,34,437
"6856",6856,58,416,631,478,"0078",1908,95,1813
"6857",6857,46,407,658,459,"0079",1451,158,1293
"6858",6858,13,117,166,131,"0080",1894,80,1814
"6859",6859,104,586,1159,695,"0081",4156,3312,844
"6860",6860,85,447,1047,537,"0082",1001,148,853
"6861",6861,115,570,1178,692,"0083",1392,103,1289
"6862",6862,93,567,1127,667,"0084",1000,272,728
"6863",6863,204,1501,2352,1730,"0085",753,50,703
"6864",6864,81,874,1355,967,"0086",644,359,285
"6865",6865,42,341,688,392,"0087",1814,372,1442
"6866",6866,70,682,1196,759,"0088",2838,928,1910
"6867",6867,82,557,971,645,"0089",874,230,644
"6868",6868,90,717,993,817,"0090",1072,326,746
"6869",6869,74,555,854,638,"0091",5686,2393,3293
"6870",6870,113,738,1149,860,"0092A",2251,1048,1203
"6871",6871,88,644,1120,749,"0092B",87,34,53
"6872",6872,93,597,1082,712,"0093",3636,294,3342
"6873",6873,5,90,131,97,"0094",2415,735,1680
"6874",6874,68,657,989,736,"0095",986,118,868
"6875",6875,13,160,234,174,"0096",1200,152,1048
"6876",6876,42,326,518,375,"0097",1529,154,1375
"6877",6877,32,176,320,212,"0098",1993,73,1920
"6878",6878,791,1834,2122,2660,"0099",974,100,874
"6879",6879,487,1212,2336,1723,"0100",1605,388,1217
"6880",6880,977,1499,3375,2508,"0101",4042,1452,2590
"6881",6881,601,743,2064,1368,"0102",1623,543,1080
"6882",6882,26,217,303,246,"0103",3272,1215,2057
"6883",6883,1145,1850,4034,3028,"0104",919,52,867
"6884",6884,287,1152,2139,1455,"0105",1493,59,1434
"6885",6885,298,1911,3069,2236,"0106",2912,883,2029
"6886",6886,259,1196,1951,1472,"0107",4933,2452,2481
"6887",6887,919,443,2741,1384,"0108",1953,695,1258
"6888",6888,294,1150,2133,1467,"0109",555,196,359
"6889",6889,311,980,2369,1307,"0110",2349,870,1479
"6890",6890,624,3019,4736,3688,"0111",1364,442,922
"6891",6891,871,2109,4613,3023,"0112",2652,903,1749
"6892",6892,657,2155,3629,2857,"0113",741,53,688
"6893",6893,385,2212,4274,2625,"0114",984,111,873
"6894",6894,441,2293,4010,2765,"0115",2622,957,1665
"6895",6895,456,1921,3476,2414,"0116",5634,1718,3916
"6896",6896,544,2237,3837,2805,"0117",3617,2463,1154
"6897",6897,524,825,2272,1368,"0118",3546,772,2774
"6898",6898,844,1728,4008,2620,"0119",4338,1625,2713
"6899",6899,662,2938,4962,3641,"0120",2684,982,1702
"6900",6900,787,1874,4209,2702,"0121",2199,521,1678
"6901",6901,678,1616,3344,2324,"0122",4382,2388,1994
"6902",6902,170,924,1828,1106,"0123",2403,1028,1375
"6903",6903,403,1114,2701,1538,"0124",3822,1443,2379
"6904",6904,579,1324,2755,1941,"0125",6794,2351,4443
"6905",6905,468,2605,4296,3102,"0126",5005,2174,2831
"6906",6906,7,32,54,39,"0127",1409,742,667
"6907",6907,4,20,33,24,"0001",1612,559,1053
"6908",6908,556,3070,4886,3689,"0002",1707,705,1002
"6909",6909,350,1844,2857,2225,"0003",1851,1170,681
"6910",6910,1251,2408,4775,3712,"0004",1821,850,971
"6911",6911,909,1154,2970,2101,"0101",90,59,31
"6912",6912,898,1622,3552,2562,"0103",141,121,20
"6913",6913,496,1550,2655,2073,"0202",168,134,34
"6914",6914,1110,2455,5295,3619,"0203",168,145,23
"6915",6915,450,1675,3497,2159,"0303",309,229,80
"6916",6916,596,1385,2998,2007,"0403",193,148,45
"6917",6917,482,2397,3668,2908,"0404",160,146,14
"6918",6918,525,3360,4961,3908,"0001",552,396,156
"6919",6919,813,2510,4372,3380,"0002",2091,818,1273
"6920",6920,316,2213,3932,2554,"0003",1725,403,1322
"6921",6921,72,467,916,546,"0004",651,54,597
"6922",6922,557,2253,3478,2841,"0005",1855,833,1022
"6923",6923,1,4,7,5,"0006",1783,1506,277
"6924",6924,0,3,5,3,"0007",1925,1406,519
"6925",6925,0,4,6,4,"0008",2376,1883,493
"6926",6926,526,1110,2841,1666,"0009",2163,1899,264
"6927",6927,697,1464,3051,2186,"0010",1041,726,315
"6928",6928,1055,1660,3389,2754,"0011",1093,682,411
"6929",6929,738,1006,2682,1786,"0012",1709,1261,448
"6930",6930,695,1193,2471,1926,"0013",1985,1150,835
"6931",6931,680,1073,2363,1795,"0014",2162,1498,664
"6932",6932,505,2662,4007,3187,"0015",1980,1545,435
"6933",6933,605,799,2860,1430,"0016",2729,2388,341
"6934",6934,503,1776,3993,2304,"0017",2341,2164,177
"6935",6935,778,2472,4523,3288,"0018",2363,2143,220
"6936",6936,227,679,1803,922,"0019",2311,2059,252
"6937",6937,208,648,1425,881,"0020",1968,1790,178
"6938",6938,1277,2265,5018,3608,"0021",281,226,55
"6939",6939,319,1721,2823,2067,"0022",1566,1391,175
"6940",6940,652,1321,2497,2025,"0023",2745,2450,295
"6941",6941,458,850,1671,1327,"0024",1943,1663,280
"6942",6942,496,802,2238,1324,"0025",2164,1784,380
"6943",6943,1633,2147,4906,3849,"0026",2826,2403,423
"6944",6944,813,1284,2734,2122,"0027",2254,2051,203
"6945",6945,575,2610,4086,3219,"0028",3091,2690,401
"6946",6946,8,38,58,46,"0029",1462,1320,142
"6947",6947,281,952,2222,1255,"0030",1207,948,259
"6948",6948,628,3275,5417,3947,"0031",2715,2436,279
"6949",6949,504,2345,4137,2879,"0032",1984,1794,190
"6950",6950,847,1245,2889,2128,"0033",1515,1399,116
"6951",6951,1113,2506,5120,3673,"0034",1920,1698,222
"6952",6952,1313,1980,4343,3343,"0001",643,535,108
"6953",6953,865,1374,2838,2259,"0002",16,16,0
"6954",6954,1378,2421,4973,3860,"0003",1006,895,111
"6955",6955,588,2941,4157,3548,"0004",513,449,64
"6956",6956,397,939,1870,1363,"0005",513,352,161
"6957",6957,436,1348,2761,1801,"0006",968,871,97
"6958",6958,1123,2035,4471,3190,"0007",711,574,137
"6959",6959,698,2700,4280,3441,"0008",1713,1475,238
"6960",6960,638,2884,4386,3542,"0009",360,343,17
"6961",6961,1468,2539,5150,4062,"0011",430,340,90
"6962",6962,597,976,2293,1612,"0012",474,393,81
"6963",6963,1010,2318,4412,3391,"0013",757,620,137
"6964",6964,30,67,128,99,"0014",214,174,40
"6965",6965,1006,1970,3932,3012,"0015",912,784,128
"6966",6966,809,1996,3756,2842,"0016",423,380,43
"6967",6967,165,896,1550,1072,"0017",1097,567,530
"6968",6968,1416,1461,4717,2931,"0018",210,179,31
"6969",6969,448,2043,3605,2527,"0020",210,196,14
"6970",6970,351,1474,2600,1855,"0021",910,681,229
"6971",6971,1252,2468,4643,3769,"0022",1080,905,175
"6972",6972,1269,2001,4228,3316,"0023",2202,1590,612
"6973",6973,702,2886,4840,3641,"0024",239,177,62
"6974",6974,579,2713,3922,3343,"0025",184,127,57
"6975",6975,455,2383,4031,2873,"0026",194,136,58
"6976",6976,1523,2064,4965,3657,"0027",2083,1667,416
"6977",6977,719,2073,4443,2838,"0028",1530,1014,516
"6978",6978,874,1834,4013,2754,"0029",1456,921,535
"6979",6979,1153,1635,4309,2840,"0030",990,488,502
"6980",6980,1140,1798,4235,2999,"0001",2220,1515,705
"6981",6981,491,2213,3335,2732,"0002",2383,1750,633
"6982",6982,639,1026,2263,1689,"0003",1337,1028,309
"6983",6983,508,2502,3661,3048,"0005",546,422,124
"6984",6984,1270,2143,4317,3471,"0007",786,563,223
"6985",6985,855,1292,2922,2176,"0008",243,207,36
"6986",6986,696,2328,3911,3064,"0009",689,560,129
"6987",6987,1213,1784,4090,3052,"0010",333,212,121
"6988",6988,156,606,960,770,"0012",407,355,52
"6989",6989,495,2384,3680,2905,"0013",309,221,88
"6990",6990,315,1495,2158,1834,"0014",494,410,84
"6991",6991,11,23,45,34,"0018",1935,1639,296
"6992",6992,810,1307,2880,2147,"0019",381,317,64
"6993",6993,236,776,1310,1031,"0020",397,335,62
"6994",6994,405,937,1911,1361,"0022",443,246,197
"6995",6995,173,939,1856,1128,"0026",152,111,41
"6996",6996,286,977,2510,1295,"0027",1249,597,652
"6997",6997,141,801,1471,955,"0028",2541,1875,666
"6998",6998,132,978,1663,1125,"0029",331,313,18
"6999",6999,7,48,74,55,"0100",4264,3551,713
"7000",7000,259,784,2259,1062,"0105",2422,2018,404
"7001",7001,88,678,1248,780,"0110",2285,1809,476
"7002",7002,149,93,760,260,"0111",1796,1426,370
"7003",7003,297,100,764,400,"0115",3238,2647,591
"7004",7004,164,108,420,272,"0120",2600,2165,435
"7005",7005,158,347,745,510,"0125",3293,2667,626
"7006",7006,134,613,1028,761,"0130",4572,3473,1099
"7007",7007,180,430,1096,622,"0135",2001,1597,404
"7008",7008,209,511,1142,735,"0140",1446,1239,207
"7009",7009,137,659,1217,810,"0200",2497,1766,731
"7010",7010,385,1073,2162,1482,"0205",2416,1784,632
"7011",7011,8,160,202,169,"0210",2209,1836,373
"7012",7012,4,71,93,75,"0215",3897,3229,668
"7013",7013,1,14,24,15,"0220",889,794,95
"7014",7014,13,143,208,156,"0225",1458,1273,185
"7015",7015,8,107,145,115,"0230",1777,1448,329
"7016",7016,12,109,181,122,"0235",1183,961,222
"7017",7017,228,1227,1968,1479,"0240",1880,1517,363
"7018",7018,164,916,1414,1093,"0245",1579,1244,335
"7019",7019,441,1636,2902,2098,"0250",1357,1176,181
"7020",7020,171,980,1636,1158,"0255",2498,1934,564
"7021",7021,443,1549,2560,2024,"0300",2023,1623,400
"7022",7022,320,1026,1963,1357,"0305",3058,2548,510
"7023",7023,679,315,1724,1017,"0310",2634,2110,524
"7024",7024,1064,991,3476,2091,"0315",4669,3883,786
"7025",7025,638,55,1359,701,"0320",2268,1931,337
"7026",7026,873,832,2769,1741,"0325",1913,1627,286
"7027",7027,984,1567,3493,2617,"0330",2454,1671,783
"7028",7028,1495,1361,4617,2938,"0335",3812,3362,450
"7029",7029,371,422,1190,802,"0340",934,832,102
"7030",7030,400,766,1805,1180,"0345",2590,2109,481
"7031",7031,227,762,1345,999,"0350",2803,2313,490
"7032",7032,199,1140,1846,1349,"0400",3379,2734,645
"7033",7033,90,551,851,648,"0405",3486,2982,504
"7034",7034,136,615,987,754,"0410",2286,2004,282
"7035",7035,77,667,985,746,"0415",3629,2932,697
"7036",7036,338,550,1456,906,"0420",2237,1936,301
"7037",7037,302,973,1792,1305,"0425",1575,1254,321
"7038",7038,97,388,739,495,"0430",3023,2521,502
"7039",7039,22,179,307,202,"0435",2978,2522,456
"7040",7040,76,269,573,349,"0440",3720,3237,483
"7041",7041,222,513,1309,756,"0445",1892,1685,207
"7042",7042,71,259,477,334,"0450",2514,2088,426
"7043",7043,46,233,423,282,"0101",1873,651,1222
"7044",7044,437,356,1482,802,"0201",1196,222,974
"7045",7045,355,41,847,401,"0202",272,127,145
"7046",7046,287,124,1032,419,"0203",88,57,31
"7047",7047,405,1047,2312,1468,"0301",1435,813,622
"7048",7048,64,159,330,225,"0302",315,237,78
"7049",7049,173,790,1243,980,"0303",204,58,146
"7050",7050,64,380,677,454,"0401",409,275,134
"7051",7051,541,784,2551,1346,"0402",1237,103,1134
"7052",7052,81,134,379,217,"0001",3686,1036,2650
"7053",7053,162,650,1236,824,"0002",2513,531,1982
"7054",7054,86,560,849,656,"0003",187,102,85
"7055",7055,72,288,593,364,"0004",795,321,474
"7056",7056,31,185,316,218,"0005",77,38,39
"7057",7057,56,273,520,330,"0006",226,51,175
"7058",7058,46,252,382,301,"0007",2120,459,1661
"7059",7059,290,865,1629,1181,"0009",229,102,127
"7060",7060,128,182,556,316,"0010",1747,336,1411
"7061",7061,282,1061,1997,1362,"0001",476,413,63
"7062",7062,126,957,1451,1091,"0002",742,635,107
"7063",7063,160,610,1176,783,"0003",2844,2280,564
"7064",7064,60,545,923,613,"0004",1840,1382,458
"7065",7065,21,193,278,216,"0005",6987,3695,3292
"7066",7066,74,447,803,533,"0006",5875,5062,813
"7067",7067,52,213,404,266,"0007",1050,605,445
"7068",7068,26,356,540,384,"0008",1278,845,433
"7069",7069,27,108,178,138,"0009",850,525,325
"7070",7070,28,327,477,356,"0010",2758,1475,1283
"7071",7071,207,421,1075,639,"0011",471,295,176
"7072",7072,20,83,203,104,"0012",469,80,389
"7073",7073,55,162,330,219,"0013",388,349,39
"7074",7074,15,50,103,66,"0014",1264,1050,214
"7075",7075,0,0,3,1,"0015",1081,977,104
"7076",7076,35,128,210,165,"0016",5269,4029,1240
"7077",7077,38,280,443,322,"0017",1575,1319,256
"7078",7078,34,359,643,397,"0018",914,379,535
"7079",7079,30,174,315,209,"0019",1784,1636,148
"7080",7080,50,531,938,587,"0020",958,861,97
"7081",7081,103,93,340,200,"0021",1791,1207,584
"7082",7082,29,173,305,203,"0121",2604,1796,808
"7083",7083,34,198,330,235,"0122",4539,2811,1728
"7084",7084,39,14,94,53,"0123",4650,3120,1530
"7085",7085,10,174,286,185,"0124",2650,1915,735
"7086",7086,9,159,231,169,"0125",4596,3117,1479
"7087",7087,95,30,200,126,"0126",4187,2274,1913
"7088",7088,21,198,343,220,"0221",3700,787,2913
"7089",7089,137,122,454,264,"0222",3945,535,3410
"7090",7090,5,82,134,88,"0223",3510,717,2793
"7091",7091,136,420,1017,563,"0224",4657,1504,3153
"7092",7092,115,602,1056,736,"0225",3245,742,2503
"7093",7093,268,761,1822,1050,"0321",2623,2242,381
"7094",7094,320,553,1805,886,"0322",215,162,53
"7095",7095,23,101,150,124,"0323",4786,3723,1063
"7096",7096,121,530,1080,662,"0324",4936,3781,1155
"7097",7097,15,201,296,218,"0325",3604,2458,1146
"7098",7098,13,125,167,140,"0326",3930,2684,1246
"7099",7099,151,838,1442,1016,"0327",7442,2845,4597
"7100",7100,406,371,1409,797,"0421",3233,605,2628
"7101",7101,802,761,2606,1594,"0422",6645,1944,4701
"7102",7102,1295,1320,3579,2667,"0424",2155,527,1628
"7103",7103,883,538,2478,1447,"0425",3569,672,2897
"7104",7104,508,599,1539,1139,"0426",1324,453,871
"7105",7105,675,1463,3582,2189,"0427",1853,351,1502
"7106",7106,249,92,765,348,"0001",324,100,224
"7107",7107,1535,1788,4969,3390,"0002",822,43,779
"7108",7108,446,830,1992,1301,"0003",46,3,43
"7109",7109,186,644,1128,836,"0004",1139,39,1100
"7110",7110,167,232,628,403,"0005",811,26,785
"7111",7111,404,335,1300,748,"0006",49,19,30
"7112",7112,360,128,1069,502,"0007",1481,626,855
"7113",7113,60,173,348,237,"0101",1558,1349,209
"7114",7114,221,279,973,509,"0102",878,782,96
"7115",7115,195,372,766,574,"0203",1656,1518,138
"7116",7116,1008,794,3072,1844,"0204",775,623,152
"7117",7117,635,1043,3236,1731,"0305",1011,811,200
"7118",7118,692,1649,3294,2390,"0306",1376,1064,312
"7119",7119,1192,637,3052,1864,"0407",1209,1079,130
"7120",7120,84,171,435,260,"0408",1183,1003,180
"7121",7121,111,137,422,257,"0110",5615,4350,1265
"7122",7122,353,1227,2169,1599,"0111",6707,2747,3960
"7123",7123,256,99,869,363,"0112",5378,3247,2131
"7124",7124,85,219,534,306,"0114",4598,2784,1814
"7125",7125,1285,1978,4472,3319,"0123",3300,2075,1225
"7126",7126,171,190,789,366,"0208",8214,6116,2098
"7127",7127,23,141,227,164,"0220",2225,1659,566
"7128",7128,1055,1249,3237,2360,"0222",4672,3675,997
"7129",7129,51,8,244,62,"0227",5376,4132,1244
"7130",7130,158,64,623,225,"0228",5176,4093,1083
"7131",7131,638,619,2103,1296,"0230",3200,2585,615
"7132",7132,153,87,1184,243,"0305",3147,2425,722
"7133",7133,135,102,537,244,"0306",4741,3693,1048
"7134",7134,263,126,887,405,"0307",4204,3354,850
"7135",7135,275,181,859,461,"0309",5107,3825,1282
"7136",7136,433,266,1374,717,"0324",5503,4364,1139
"7137",7137,97,26,468,124,"0325",4461,3510,951
"7138",7138,147,143,599,293,"0415",6137,3902,2235
"7139",7139,827,2252,4257,3137,"0418",5993,4440,1553
"7140",7140,92,62,434,159,"0421",5421,3724,1697
"7141",7141,131,185,407,322,"0426",3059,2390,669
"7142",7142,190,81,574,275,"0429",4519,3324,1195
"7143",7143,247,110,1021,363,"0001",594,63,531
"7144",7144,146,42,580,191,"0002",630,281,349
"7145",7145,83,35,366,119,"0003A",468,190,278
"7146",7146,101,41,457,146,"0003B",101,65,36
"7147",7147,502,359,1435,887,"0004",609,187,422
"7148",7148,199,470,1014,679,"0001",669,511,158
"7149",7149,195,130,535,334,"0002",645,501,144
"7150",7150,586,383,2136,989,"0003",466,282,184
"7151",7151,338,95,874,437,"0004",137,122,15
"7152",7152,255,110,754,370,"0006",307,248,59
"7153",7153,548,267,1384,834,"0007",58,42,16
"7154",7154,379,185,1013,573,"0001",93,64,29
"7155",7155,282,133,1148,423,"0002",825,525,300
"7156",7156,264,168,804,440,"0003",1272,659,613
"7157",7157,448,378,1171,844,"0004",1173,654,519
"7158",7158,526,404,1508,954,"0005",1204,1066,138
"7159",7159,346,93,1050,444,"0007",300,239,61
"7160",7160,253,62,817,319,"0009",304,273,31
"7161",7161,252,121,912,377,"0010",223,207,16
"7162",7162,776,909,2317,1730,"0011",171,161,10
"7163",7163,295,399,863,708,"0013",918,792,126
"7164",7164,1021,1130,3143,2218,"0014",244,212,32
"7165",7165,517,356,1505,896,"0017",241,199,42
"7166",7166,1240,1419,4038,2714,"0018",208,177,31
"7167",7167,364,183,1039,556,"0019",428,381,47
"7168",7168,641,392,1882,1046,"0020",179,107,72
"7169",7169,830,514,2698,1376,"0021",164,124,40
"7170",7170,516,224,1692,756,"0024",195,168,27
"7171",7171,520,311,1645,843,"0027",437,393,44
"7172",7172,488,215,1440,712,"0028",243,172,71
"7173",7173,555,189,1705,754,"0029",155,138,17
"7174",7174,673,231,2161,923,"0030",164,148,16
"7175",7175,203,76,813,282,"0031",138,129,9
"7176",7176,92,21,293,117,"0001",597,35,562
"7177",7177,571,190,1630,775,"0002",1023,121,902
"7178",7178,336,143,1130,487,"0003",957,208,749
"7179",7179,538,150,1561,696,"0004",3068,143,2925
"7180",7180,830,2254,4273,3138,"0005",436,102,334
"7181",7181,152,90,671,246,"0006",231,81,150
"7182",7182,337,126,1053,472,"0007",985,190,795
"7183",7183,236,180,815,427,"0008",691,83,608
"7184",7184,172,31,511,207,"0010",1506,169,1337
"7185",7185,244,234,629,493,"0011",1008,57,951
"7186",7186,472,341,1423,827,"0012",1117,249,868
"7187",7187,786,741,2311,1554,"0001",684,192,492
"7188",7188,184,152,692,346,"0002",851,556,295
"7189",7189,263,231,851,503,"0003",746,368,378
"7190",7190,1096,953,3683,2106,"0004",557,118,439
"7191",7191,612,592,1822,1237,"001A",638,200,438
"7192",7192,23,23,67,46,"002A",201,142,59
"7193",7193,899,479,2814,1407,"002B",277,174,103
"7194",7194,675,529,2017,1230,"003A",718,401,317
"7195",7195,283,124,809,419,"004A",444,175,269
"7196",7196,300,156,907,465,"004B",128,73,55
"7197",7197,397,144,1121,548,"0001",167,150,17
"7198",7198,640,185,1692,844,"0002",142,128,14
"7199",7199,160,76,586,245,"0003",166,140,26
"7200",7200,326,340,1246,675,"04-1",76,69,7
"7201",7201,809,1151,3201,1989,"04-2",75,69,6
"7202",7202,375,554,1484,949,"0001",1141,595,546
"7203",7203,630,1067,2528,1723,"0002",1805,839,966
"7204",7204,251,119,860,381,"0003",560,479,81
"7205",7205,358,148,1250,520,"0004",499,437,62
"7206",7206,748,649,2265,1419,"0005",1518,1132,386
"7207",7207,843,2282,4414,3186,"0006",1844,1405,439
"7208",7208,194,153,707,354,"0007",144,60,84
"7209",7209,163,160,483,325,"0008",252,242,10
"7210",7210,322,523,1443,857,"0011",1398,921,477
"7211",7211,253,378,1036,640,"0013",176,166,10
"7212",7212,730,713,2100,1459,"0016",195,157,38
"7213",7213,169,44,456,217,"0018",96,89,7
"7214",7214,179,101,685,285,"0019",692,617,75
"7215",7215,580,616,2001,1224,"0022",1330,227,1103
"7216",7216,1397,1282,4202,2723,"0023",1072,311,761
"7217",7217,590,1470,3247,2114,"0001A",5462,4185,1277
"7218",7218,898,594,2583,1516,"0001B",0,0,0
"7219",7219,858,1097,3078,2004,"0002",5054,3776,1278
"7220",7220,624,653,2167,1307,"0003",970,564,406
"7221",7221,508,403,1507,932,"0004",3447,2487,960
"7222",7222,742,1613,3659,2418,"001AA",3799,2501,1298
"7223",7223,476,876,2033,1366,"001AB",1256,612,644
"7224",7224,958,1110,3135,2109,"001B",6283,4901,1382
"7225",7225,898,1091,2907,2022,"001C",3278,2676,602
"7226",7226,1021,1569,3602,2647,"002A",4882,3427,1455
"7227",7227,353,887,1564,1272,"002B",2183,1370,813
"7228",7228,853,1034,2771,1926,"002C",5478,4495,983
"7229",7229,52,394,914,457,"003A",2735,661,2074
"7230",7230,69,591,1150,668,"003B",3583,1923,1660
"7231",7231,98,1057,1736,1175,"003C",2823,2341,482
"7232",7232,83,770,1375,864,"003D",7837,5663,2174
"7233",7233,19,132,261,156,"004A",12185,7307,4878
"7234",7234,5,128,170,134,"004B",2104,1311,793
"7235",7235,15,99,162,115,"004C",5166,3448,1718
"7236",7236,11,154,203,167,"0001",1795,1086,709
"7237",7237,15,199,311,216,"0002",128,87,41
"7238",7238,7,78,135,88,"0003",1702,1088,614
"7239",7239,9,127,175,137,"0004A",566,285,281
"7240",7240,32,170,381,206,"0004B",40,35,5
"7241",7241,430,249,1339,695,"0005",186,160,26
"7242",7242,580,127,1391,713,"0006",140,115,25
"7243",7243,219,7,483,228,"0007",1040,698,342
"7244",7244,466,449,1556,932,"0008",787,578,209
"7245",7245,203,962,1628,1183,"0009",872,537,335
"7246",7246,293,816,1667,1129,"0010",380,301,79
"7247",7247,260,1476,2533,1759,"0111",2999,1714,1285
"7248",7248,214,1295,2193,1528,"0112",3200,2100,1100
"7249",7249,100,446,838,550,"0113",3695,2625,1070
"7250",7250,97,244,678,345,"0114",1725,1223,502
"7251",7251,170,573,1255,760,"0201",3295,1646,1649
"7252",7252,292,504,1517,812,"0212",926,698,228
"7253",7253,368,722,1704,1108,"0213",2185,1625,560
"7254",7254,224,935,1699,1172,"0214",2470,1824,646
"7255",7255,160,1596,2465,1778,"0215",2324,1491,833
"7256",7256,110,1127,1889,1257,"0302",1370,564,806
"7257",7257,151,1143,2065,1315,"0303",2525,944,1581
"7258",7258,136,894,1774,1054,"0314A",1013,805,208
"7259",7259,106,813,1536,929,"0314B",130,33,97
"7260",7260,25,155,325,186,"0315",988,819,169
"7261",7261,75,625,1040,710,"0316",603,489,114
"7262",7262,194,1855,2804,2076,"0317",731,379,352
"7263",7263,107,911,1538,1032,"0318",1160,842,318
"7264",7264,132,1042,1784,1193,"0319",340,190,150
"7265",7265,197,1348,2250,1565,"0404",1826,1356,470
"7266",7266,149,1285,2095,1449,"0405",1345,911,434
"7267",7267,259,2029,2950,2324,"0416",1292,835,457
"7268",7268,81,633,1130,728,"0417",2006,1179,827
"7269",7269,79,594,1039,689,"0418",2570,1770,800
"7270",7270,142,1089,1840,1249,"0001",2056,1759,297
"7271",7271,110,1229,1852,1355,"0002",1539,1435,104
"7272",7272,93,902,1514,1012,"0003",630,407,223
"7273",7273,103,941,1623,1058,"0004",250,239,11
"7274",7274,79,332,537,416,"0005",1266,1161,105
"7275",7275,1,15,31,16,"0006",1780,1512,268
"7276",7276,101,601,945,703,"0007",189,90,99
"7277",7277,38,331,557,374,"0008",353,308,45
"7278",7278,67,269,487,340,"0001",1454,832,622
"7279",7279,148,606,945,763,"0002",347,170,177
"7280",7280,44,363,594,410,"0003",363,229,134
"7281",7281,139,1133,1690,1285,"0004",496,301,195
"7282",7282,51,260,368,312,"0005",450,353,97
"7283",7283,21,160,302,183,"0006",291,259,32
"7284",7284,51,267,462,321,"0007",353,294,59
"7285",7285,81,403,691,488,"0008",737,686,51
"7286",7286,13,90,178,105,"0009",956,885,71
"7287",7287,71,590,906,666,"0010",404,360,44
"7288",7288,36,306,421,345,"0011",435,27,408
"7289",7289,122,301,857,431,"0001",3167,2455,712
"7290",7290,18,114,199,132,"0002",5198,3488,1710
"7291",7291,11,153,207,166,"0003",1281,991,290
"7292",7292,120,455,859,578,"0004",837,725,112
"7293",7293,70,611,1000,690,"0005",2995,1821,1174
"7294",7294,215,700,1605,926,"0006",2102,1758,344
"7295",7295,26,112,257,138,"0007",2199,1755,444
"7296",7296,16,61,166,80,"0008",1358,1108,250
"7297",7297,13,37,105,50,"0010",558,504,54
"7298",7298,249,868,1729,1135,"0013",955,564,391
"7299",7299,93,333,902,429,"0014",797,545,252
"7300",7300,144,413,1003,569,"0101",554,201,353
"7301",7301,140,295,872,444,"0102",2766,795,1971
"7302",7302,244,929,1748,1186,"0103",501,295,206
"7303",7303,283,1228,2253,1528,"0104",1949,608,1341
"7304",7304,179,798,1372,983,"0105",1931,284,1647
"7305",7305,30,328,464,359,"0106",2116,1145,971
"7306",7306,94,442,828,544,"0107",293,135,158
"7307",7307,34,144,262,182,"0108",5733,2750,2983
"7308",7308,87,421,737,512,"0109",3818,1810,2008
"7309",7309,62,173,359,238,"0110",2117,631,1486
"7310",7310,10,293,401,306,"0111",60,16,44
"7311",7311,61,169,350,232,"0112",1497,87,1410
"7312",7312,23,317,454,342,"0113",1388,153,1235
"7313",7313,229,1268,2032,1510,"0114",2802,1512,1290
"7314",7314,13,246,349,259,"0115",5060,3062,1998
"7315",7315,2,254,353,257,"0116",5182,3140,2042
"7316",7316,98,139,391,239,"0117",721,284,437
"7317",7317,39,100,180,142,"0118",2406,479,1927
"7318",7318,339,598,1605,946,"0119",1308,846,462
"7319",7319,221,1239,2310,1472,"0120",812,589,223
"7320",7320,9,240,349,253,"0121",3085,1475,1610
"7321",7321,661,2511,4184,3225,"0122",864,473,391
"7322",7322,265,1367,2279,1663,"0123",166,44,122
"7323",7323,255,1007,1947,1287,"0124",4187,912,3275
"7324",7324,174,799,1440,993,"0125",61,29,32
"7325",7325,340,1589,2999,1963,"0001",1100,680,420
"7326",7326,234,1323,2290,1587,"002A",584,507,77
"7327",7327,218,1833,2909,2072,"002B",513,295,218
"7328",7328,377,2040,3671,2452,"003A",548,460,88
"7329",7329,212,1063,1776,1295,"003B",416,226,190
"7330",7330,126,832,1377,974,"004A",1302,852,450
"7331",7331,238,864,1895,1121,"004B",143,134,9
"7332",7332,290,941,2000,1272,"0001",551,273,278
"7333",7333,157,1316,1981,1501,"0002",494,201,293
"7334",7334,363,2374,3754,2773,"0003",273,92,181
"7335",7335,48,508,755,563,"0004",549,366,183
"7336",7336,103,882,1384,995,"0005",112,79,33
"7337",7337,194,987,1606,1202,"0006",271,230,41
"7338",7338,98,762,1159,874,"0007",2484,1567,917
"7339",7339,132,1099,1784,1250,"0008",1170,701,469
"7340",7340,145,866,1451,1025,"0009",505,406,99
"7341",7341,172,915,1493,1110,"0010",1647,1076,571
"7342",7342,265,1081,2063,1374,"0011",168,133,35
"7343",7343,499,2185,3466,2742,"0012",2189,1139,1050
"7344",7344,206,933,1469,1157,"0013",491,339,152
"7345",7345,340,900,1736,1270,"0014",1086,518,568
"7346",7346,395,1571,2896,2017,"0015",2526,822,1704
"7347",7347,319,834,1834,1184,"0101",540,455,85
"7348",7348,549,2232,4147,2854,"0202",596,523,73
"7349",7349,209,1392,2130,1630,"0303",334,305,29
"7350",7350,213,1241,1964,1469,"0307",317,276,41
"7351",7351,178,880,1769,1073,"0404",53,44,9
"7352",7352,285,2923,4014,3246,"0405",218,193,25
"7353",7353,97,708,956,813,"0406A",302,253,49
"7354",7354,216,1397,2275,1644,"0406B",2,2,0
"7355",7355,245,1731,2677,2016,"0002",889,760,129
"7356",7356,496,2002,3360,2535,"0003",309,263,46
"7357",7357,336,1313,2216,1676,"0004",837,650,187
"7358",7358,810,2188,3640,3063,"0005",2419,1977,442
"7359",7359,307,1481,2281,1815,"0006",610,527,83
"7360",7360,504,1762,3007,2319,"0007",794,538,256
"7361",7361,489,1856,3070,2396,"0008",1330,700,630
"7362",7362,541,2637,4036,3236,"001N",1830,1051,779
"7363",7363,274,1352,2073,1647,"001S",2296,1377,919
"7364",7364,442,1568,2639,2049,"001W",663,358,305
"7365",7365,153,621,1319,792,"009N",1261,855,406
"7366",7366,138,264,867,409,"009S",1065,802,263
"7367",7367,9,188,276,200,"01SE",2302,589,1713
"7368",7368,92,712,1190,814,"01SW",1466,1043,423
"7369",7369,2,22,41,24,"0101",117,66,51
"7370",7370,21,206,309,232,"0102",429,146,283
"7371",7371,73,122,529,198,"0201",305,112,193
"7372",7372,377,841,2036,1255,"0202",142,99,43
"7373",7373,407,694,2096,1131,"0301",167,114,53
"7374",7374,11,154,237,169,"0302",282,199,83
"7375",7375,57,389,706,456,"0401",532,324,208
"7376",7376,0,44,62,45,"0001",1031,203,828
"7377",7377,25,65,148,91,"0002",1493,80,1413
"7378",7378,321,593,1723,930,"0003",2785,2147,638
"7379",7379,19,140,241,167,"0004",3150,971,2179
"7380",7380,165,295,1040,476,"0005",4984,4000,984
"7381",7381,29,263,448,295,"0006",1100,848,252
"7382",7382,43,333,598,378,"0007",2536,1662,874
"7383",7383,191,739,1543,933,"0008",1692,1284,408
"7384",7384,366,1449,2876,1840,"0009",529,80,449
"7385",7385,103,427,847,535,"0010",3847,1575,2272
"7386",7386,380,2193,4001,2594,"0011",3246,304,2942
"7387",7387,118,305,755,433,"0012",2229,213,2016
"7388",7388,195,595,1362,797,"0013",1940,33,1907
"7389",7389,100,426,834,530,"0014",2275,1075,1200
"7390",7390,419,959,2318,1391,"0015",4489,3985,504
"7391",7391,62,163,361,227,"0016",1740,221,1519
"7392",7392,108,66,350,179,"0017",1293,1077,216
"7393",7393,30,261,400,293,"0018",2271,228,2043
"7394",7394,166,975,1902,1149,"0019",5849,4635,1214
"7395",7395,188,1359,2474,1567,"0020",1233,211,1022
"7396",7396,255,1265,2392,1532,"0021",1597,1282,315
"7397",7397,155,832,1509,991,"0022",1568,934,634
"7398",7398,263,415,1257,686,"0023",2843,1770,1073
"7399",7399,818,1854,5116,2697,"0025",2372,1846,526
"7400",7400,1023,2163,5966,3222,"0026",3096,2481,615
"7401",7401,251,1253,2346,1512,"0027",2734,1729,1005
"7402",7402,124,278,768,405,"0028",4947,3783,1164
"7403",7403,318,1162,2080,1506,"0029",2247,1618,629
"7404",7404,450,1200,2860,1690,"0030",5087,4161,926
"7405",7405,771,1517,3560,2372,"0031",4540,3642,898
"7406",7406,388,1239,2326,1676,"0032",3567,2484,1083
"7407",7407,777,1469,3653,2306,"0034",1631,340,1291
"7408",7408,513,962,2740,1526,"0035",3238,1394,1844
"7409",7409,307,438,1812,765,"0036",5299,1369,3930
"7410",7410,283,522,2000,815,"0037",1684,1303,381
"7411",7411,426,467,2146,914,"0038",3417,2336,1081
"7412",7412,597,877,2994,1504,"0039",408,106,302
"7413",7413,360,438,1864,809,"0040",5355,4326,1029
"7414",7414,193,1836,2614,2060,"0041",4356,3506,850
"7415",7415,18,143,209,163,"0042",4440,3399,1041
"7416",7416,383,2507,4229,2937,"0043",978,742,236
"7417",7417,721,2639,4372,3423,"0044",4784,2586,2198
"7418",7418,460,1241,2689,1744,"0045",1459,1266,193
"7419",7419,317,1531,2970,1891,"0046",1502,873,629
"7420",7420,140,630,1419,798,"0047",518,278,240
"7421",7421,314,292,1696,624,"0048",1303,388,915
"7422",7422,974,684,4189,1692,"0049",415,134,281
"7423",7423,432,290,1558,731,"0050",2455,1889,566
"7424",7424,460,410,2007,890,"0052",2279,1758,521
"7425",7425,137,186,773,330,"0054",4159,3040,1119
"7426",7426,182,140,942,329,"0055",7432,4097,3335
"7427",7427,214,108,562,327,"0056",4386,3080,1306
"7428",7428,123,94,591,223,"0058",3834,2739,1095
"7429",7429,14,10,47,24,"0059",3770,2829,941
"7430",7430,260,128,1036,399,"0060",1562,435,1127
"7431",7431,243,144,1112,391,"0061",3146,1689,1457
"7432",7432,3,12,43,16,"0063",202,39,163
"7433",7433,606,225,1389,839,"0064",333,158,175
"7434",7434,75,866,1268,955,"0065",141,60,81
"7435",7435,103,475,846,584,"0066",1164,422,742
"7436",7436,135,989,1505,1133,"0070",610,428,182
"7437",7437,61,416,680,480,"0071",4450,3390,1060
"7438",7438,109,576,874,691,"0072",417,293,124
"7439",7439,163,589,1105,758,"0073",834,346,488
"7440",7440,99,674,1061,778,"0074",798,627,171
"7441",7441,97,570,956,674,"0075",3313,3021,292
"7442",7442,248,729,1435,998,"0076",1888,323,1565
"7443",7443,237,1577,2541,1833,"0077",462,210,252
"7444",7444,856,1947,5052,2849,"0078",166,104,62
"7445",7445,614,1526,4064,2197,"0079",4099,3000,1099
"7446",7446,563,1613,3538,2213,"0080",32,22,10
"7447",7447,71,211,411,286,"0081",358,89,269
"7448",7448,250,1723,2773,1990,"0082",71,30,41
"7449",7449,581,2410,4066,3038,"0001",1531,1119,412
"7450",7450,152,679,1136,842,"0002",1844,1584,260
"7451",7451,278,1159,1959,1466,"0003",1894,1438,456
"7452",7452,640,2520,4365,3217,"0004",1699,1402,297
"7453",7453,473,1998,3385,2503,"0001",3382,147,3235
"7454",7454,769,2923,5016,3738,"0002",7579,143,7436
"7455",7455,694,3039,5030,3794,"0003",2692,26,2666
"7456",7456,181,861,1529,1064,"0004",716,40,676
"7457",7457,359,1531,2652,1943,"0005",133,2,131
"7458",7458,432,1842,3252,2312,"0006",9903,158,9745
"7459",7459,297,1405,2290,1739,"0007",939,26,913
"7460",7460,130,651,1055,793,"0008",4397,69,4328
"7461",7461,301,2227,4062,2562,"0009",6450,86,6364
"7462",7462,52,232,384,289,"0010",9919,149,9770
"7463",7463,24,165,253,194,"1-11",1536,1093,443
"7464",7464,682,2979,4906,3704,"2-11",1437,1130,307
"7465",7465,183,1307,1982,1516,"2-19A",68,49,19
"7466",7466,207,1453,2210,1687,"2-19B",118,111,7
"7467",7467,552,2038,3808,2637,"2-19C",5,5,0
"7468",7468,602,1953,3909,2610,"3-11",1101,641,460
"7469",7469,532,1850,3555,2419,"3-19",1025,689,336
"7470",7470,544,1624,3561,2212,"4-11",784,528,256
"7471",7471,506,2506,4252,3061,"4-19",962,828,134
"7472",7472,792,2118,4499,2980,"5-11",91,90,1
"7473",7473,36,122,373,159,"0001A",217,177,40
"7474",7474,62,322,577,389,"0001B",50,38,12
"7475",7475,36,234,405,273,"0002A",183,88,95
"7476",7476,3,45,81,48,"0002B",24,8,16
"7477",7477,35,219,436,255,"0002C",62,28,34
"7478",7478,84,391,631,484,"0002D",10,6,4
"7479",7479,87,452,602,546,"0002E",0,0,0
"7480",7480,85,363,654,449,"0003",220,160,60
"7481",7481,12,111,144,123,"0004",249,169,80
"7482",7482,52,326,468,380,"0001",257,200,57
"7483",7483,3,33,55,36,"0002",225,189,36
"7484",7484,262,373,990,638,"0003",252,213,39
"7485",7485,81,659,1089,747,"0004",269,210,59
"7486",7486,33,168,251,201,"0101",599,144,455
"7487",7487,0,0,0,0,"0201",617,296,321
"7488",7488,10,215,284,226,"0301",735,410,325
"7489",7489,16,140,220,162,"0401",604,165,439
"7490",7490,13,107,183,120,"0001",1247,497,750
"7491",7491,21,162,259,184,"0002",1173,584,589
"7492",7492,10,109,169,119,"0003",882,534,348
"7493",7493,27,113,189,140,"0004",629,189,440
"7494",7494,26,296,446,325,"0006",412,173,239
"7495",7495,44,124,248,168,"0007",502,412,90
"7496",7496,26,91,163,119,"0009",32,31,1
"7497",7497,8,89,132,97,"0011",392,216,176
"7498",7498,6,113,148,120,"1001",2026,1302,724
"7499",7499,29,67,148,96,"1004",3122,1406,1716
"7500",7500,14,27,65,43,"1005",1037,56,981
"7501",7501,85,174,390,261,"1008",421,38,383
"7502",7502,250,333,930,587,"1009",1748,1144,604
"7503",7503,91,100,306,196,"1010",1087,242,845
"7504",7504,43,281,497,328,"1011",2255,195,2060
"7505",7505,25,142,259,171,"1012",2945,1100,1845
"7506",7506,0,4,7,4,"1013",2966,374,2592
"7507",7507,16,135,240,153,"1014",1279,322,957
"7508",7508,19,165,248,185,"1015",1687,623,1064
"7509",7509,16,142,219,160,"1019",1524,224,1300
"7510",7510,16,27,61,43,"1021",3039,2341,698
"7511",7511,24,41,100,65,"1022",1281,772,509
"7512",7512,3,8,15,11,"1023",4719,2235,2484
"7513",7513,29,79,159,108,"1024",4657,2666,1991
"7514",7514,244,361,1185,613,"1025",2987,706,2281
"7515",7515,198,406,1214,607,"1034",3719,2675,1044
"7516",7516,0,2,9,2,"1056",1405,557,848
"7517",7517,87,179,483,270,"1059",1091,155,936
"7518",7518,26,36,139,65,"1061",444,51,393
"7519",7519,272,480,1531,759,"1062",20,18,2
"7520",7520,82,155,602,243,"1066",1776,452,1324
"7521",7521,280,448,1484,737,"1071",4801,1991,2810
"7522",7522,205,182,904,389,"1074",1774,86,1688
"7523",7523,134,150,485,291,"1075",1859,219,1640
"7524",7524,144,521,922,685,"1076",1117,887,230
"7525",7525,95,308,579,416,"1078",1262,74,1188
"7526",7526,190,169,636,366,"1079",1793,100,1693
"7527",7527,189,187,577,389,"1080",1933,69,1864
"7528",7528,17,140,197,159,"1081",4040,1656,2384
"7529",7529,67,138,307,215,"1082",1200,290,910
"7530",7530,114,357,706,479,"1083",1994,135,1859
"7531",7531,105,163,426,274,"1084",0,0,0
"7532",7532,53,77,165,131,"1085",1451,269,1182
"7533",7533,3,126,162,132,"1088",2595,225,2370
"7534",7534,2,135,170,137,"1089",2085,111,1974
"7535",7535,4,121,163,126,"1090",2601,162,2439
"7536",7536,3,74,94,77,"1094",2595,1172,1423
"7537",7537,5,73,89,78,"1095",766,694,72
"7538",7538,374,542,1300,948,"1098",3109,106,3003
"7539",7539,314,496,1335,823,"1099",1597,331,1266
"7540",7540,62,394,588,463,"1103",1563,999,564
"7541",7541,74,466,694,544,"1104",3589,311,3278
"7542",7542,238,812,1482,1061,"1105",1691,1086,605
"7543",7543,192,917,1547,1122,"1106",2504,72,2432
"7544",7544,19,178,238,201,"1108",2193,1733,460
"7545",7545,209,653,1242,878,"1109",2598,608,1990
"7546",7546,21,163,219,186,"1111",3479,2673,806
"7547",7547,25,165,265,194,"1117",2209,1644,565
"7548",7548,47,402,571,455,"1119",4853,1690,3163
"7549",7549,596,251,1570,863,"1120",3402,277,3125
"7550",7550,203,207,770,415,"1126",1864,596,1268
"7551",7551,1132,2381,4486,3586,"1127",1790,78,1712
"7552",7552,1025,2316,4612,3429,"1132",2687,104,2583
"7553",7553,388,745,1511,1158,"1133",2289,1257,1032
"7554",7554,257,676,1256,953,"1142",1534,890,644
"7555",7555,0,0,0,0,"1146",3095,1221,1874
"7556",7556,807,1375,3114,2223,"1149",5340,881,4459
"7557",7557,954,2559,4445,3567,"1150",2476,439,2037
"7558",7558,0,0,0,0,"1151",1916,598,1318
"7559",7559,993,2398,4335,3449,"1153",2254,115,2139
"7560",7560,259,435,987,704,"1154",4431,848,3583
"7561",7561,426,1165,2035,1617,"1165",297,140,157
"7562",7562,816,1664,3348,2545,"1167",1811,963,848
"7563",7563,537,909,2018,1481,"1170",3750,1386,2364
"7564",7564,318,970,1588,1311,"1175",2397,891,1506
"7565",7565,846,1092,2746,1978,"1184",1839,735,1104
"7566",7566,894,1181,3200,2121,"1186",809,648,161
"7567",7567,215,332,859,566,"1188",724,37,687
"7568",7568,602,1839,3171,2489,"1189",2923,1198,1725
"7569",7569,12,38,64,51,"1197",4714,2432,2282
"7570",7570,748,1855,3497,2659,"1198",1071,250,821
"7571",7571,6,20,33,26,"1199",369,261,108
"7572",7572,581,1956,3170,2582,"1206",3105,2427,678
"7573",7573,723,2276,3869,3053,"1207",3330,1610,1720
"7574",7574,530,1608,2628,2172,"1208",2055,1638,417
"7575",7575,1073,1996,4097,3146,"1211",3241,186,3055
"7576",7576,825,1946,4010,2827,"1227A",2263,497,1766
"7577",7577,320,832,1608,1177,"1227B",0,0,0
"7578",7578,355,675,1366,1050,"1236",860,489,371
"7579",7579,657,1234,2526,1932,"1237",1866,254,1612
"7580",7580,113,253,494,370,"1238",3868,1154,2714
"7581",7581,134,817,1669,961,"1241",849,202,647
"7582",7582,124,842,1629,977,"1244",205,115,90
"7583",7583,40,174,408,215,"1251",5024,838,4186
"7584",7584,8,123,187,133,"1255",3908,1161,2747
"7585",7585,10,93,133,104,"1257",2587,725,1862
"7586",7586,103,560,1067,674,"1264",1941,1255,686
"7587",7587,48,419,689,471,"1265",2441,975,1466
"7588",7588,68,485,802,559,"1270",957,420,537
"7589",7589,17,294,430,315,"1271",3407,2496,911
"7590",7590,102,539,962,653,"1273",4362,796,3566
"7591",7591,232,1069,2152,1325,"1277A",1641,910,731
"7592",7592,401,1646,3093,2083,"1277B",0,0,0
"7593",7593,211,869,1655,1090,"1278",3176,586,2590
"7594",7594,159,474,1037,650,"1279",2778,754,2024
"7595",7595,103,529,899,639,"1291",2491,123,2368
"7596",7596,240,1152,2011,1407,"1292",3144,548,2596
"7597",7597,412,1442,2442,1877,"1293",2225,283,1942
"7598",7598,405,1191,2371,1615,"1294",3701,2215,1486
"7599",7599,316,344,1208,666,"1295",1410,294,1116
"7600",7600,441,471,1851,924,"1296",3411,2216,1195
"7601",7601,99,635,1023,739,"1297",3835,183,3652
"7602",7602,5,52,81,57,"1298",4434,3356,1078
"7603",7603,62,560,857,628,"1300",3471,828,2643
"7604",7604,39,295,475,340,"1301",2587,293,2294
"7605",7605,171,249,766,424,"1311",2246,526,1720
"7606",7606,148,618,1137,776,"1337",2605,2089,516
"7607",7607,102,153,395,259,"1339",3914,2459,1455
"7608",7608,226,970,1693,1218,"1345",616,287,329
"7609",7609,171,713,1304,896,"1346",1629,85,1544
"7610",7610,105,540,1018,652,"1347",3868,1485,2383
"7611",7611,216,767,1616,993,"1348",965,728,237
"7612",7612,263,1256,2262,1536,"1351",0,0,0
"7613",7613,129,1234,1965,1384,"1352",800,586,214
"7614",7614,113,975,1479,1095,"1366",0,0,0
"7615",7615,101,270,619,376,"1376",4086,1779,2307
"7616",7616,12,184,266,196,"1377",5559,2834,2725
"7617",7617,65,794,1357,867,"1378",5235,985,4250
"7618",7618,150,1064,1805,1224,"1380",2165,1046,1119
"7619",7619,71,55,210,127,"1382",4698,1093,3605
"7620",7620,28,208,331,239,"1388",5175,1269,3906
"7621",7621,290,544,1378,839,"1394",0,0,0
"7622",7622,115,129,397,244,"1404",60,21,39
"7623",7623,52,125,280,178,"1407",73,32,41
"7624",7624,98,186,416,285,"1408",311,113,198
"7625",7625,39,235,385,274,"1412",0,0,0
"7626",7626,17,204,337,223,"1414",57,20,37
"7627",7627,29,219,374,250,"1415",3461,482,2979
"7628",7628,37,451,705,489,"1416",181,102,79
"7629",7629,74,610,900,685,"1418",0,0,0
"7630",7630,19,295,457,314,"1420",0,0,0
"7631",7631,210,9,469,221,"1423",2386,1892,494
"7632",7632,480,1761,3369,2265,"1424",10,8,2
"7633",7633,454,2006,4272,2486,"1427",13,10,3
"7634",7634,116,517,913,646,"1430",21,2,19
"7635",7635,38,509,739,551,"1431",2542,1805,737
"7636",7636,149,1184,2185,1352,"1434",0,0,0
"7637",7637,265,1251,1996,1532,"1436",1739,486,1253
"7638",7638,381,1159,2166,1557,"1437",917,445,472
"7639",7639,173,638,1161,819,"1439",310,25,285
"7640",7640,46,369,579,424,"1440",3363,536,2827
"7641",7641,77,419,773,498,"1441",1603,296,1307
"7642",7642,158,348,760,510,"1444",101,30,71
"7643",7643,134,180,497,316,"1445",65,21,44
"7644",7644,691,875,2607,1594,"1455",0,0,0
"7645",7645,48,235,431,286,"1457",0,0,0
"7646",7646,313,629,1634,954,"1459",2532,554,1978
"7647",7647,550,389,1848,953,"1460",5579,1023,4556
"7648",7648,143,296,847,451,"1463",4167,893,3274
"7649",7649,56,124,263,180,"1472",396,319,77
"7650",7650,703,1687,3800,2440,"1473",260,59,201
"7651",7651,483,1342,3034,1852,"1476",247,57,190
"7652",7652,406,630,1892,1051,"1477",2599,141,2458
"7653",7653,27,69,155,98,"1479",368,62,306
"7654",7654,538,277,1824,828,"1481",1251,137,1114
"7655",7655,614,868,2424,1503,"1482",1599,136,1463
"7656",7656,317,985,2151,1334,"1489",2992,765,2227
"7657",7657,778,2168,4989,2977,"1490",947,248,699
"7658",7658,510,1689,3083,2223,"1491",13,8,5
"7659",7659,95,246,562,345,"1501",774,294,480
"7660",7660,799,935,3138,1753,"1504",2525,1934,591
"7661",7661,247,583,1229,855,"1514",0,0,0
"7662",7662,119,379,762,504,"1515",58,33,25
"7663",7663,405,875,2222,1301,"1518",1760,472,1288
"7664",7664,4,20,41,24,"1543",0,0,0
"7665",7665,23,51,120,75,"1544",23,5,18
"7666",7666,977,964,3552,1964,"1547",0,0,0
"7667",7667,8,20,51,31,"1549",0,0,0
"7668",7668,68,583,936,652,"1550",45,3,42
"7669",7669,58,407,673,465,"1555",58,9,49
"7670",7670,18,177,289,196,"1559",267,59,208
"7671",7671,47,342,569,392,"1564",0,0,0
"7672",7672,32,238,389,270,"1576",655,18,637
"7673",7673,56,488,791,545,"1577",2435,217,2218
"7674",7674,8,73,122,82,"1578",2497,524,1973
"7675",7675,55,226,421,282,"1586",24,0,24
"7676",7676,63,228,443,292,"1589",317,155,162
"7677",7677,57,167,353,225,"1594",0,0,0
"7678",7678,36,319,487,360,"1597",986,83,903
"7679",7679,10,71,101,85,"1603",5497,1442,4055
"7680",7680,20,218,360,243,"1605",0,0,0
"7681",7681,210,1258,2167,1492,"1607",0,0,0
"7682",7682,68,481,930,560,"1608",894,675,219
"7683",7683,25,360,515,391,"1610",0,0,0
"7684",7684,70,620,975,696,"1611",26,4,22
"7685",7685,7,100,141,108,"1617",68,26,42
"7686",7686,148,834,1691,1007,"1619",45,1,44
"7687",7687,46,289,471,337,"1621",150,30,120
"7688",7688,11,81,119,93,"1622",45,16,29
"7689",7689,203,671,1974,885,"1623",0,0,0
"7690",7690,12,120,189,135,"1625",0,0,0
"7691",7691,21,244,379,266,"1627",326,218,108
"7692",7692,25,405,588,435,"1628",0,0,0
"7693",7693,10,182,306,198,"1631",358,127,231
"7694",7694,14,172,251,186,"1633",66,28,38
"7695",7695,1,27,41,28,"1639",5789,1042,4747
"7696",7696,22,145,254,172,"1641",4157,1518,2639
"7697",7697,25,189,308,215,"1642",3180,754,2426
"7698",7698,0,0,1,0,"1651",0,0,0
"7699",7699,54,501,823,560,"1652",419,16,403
"7700",7700,12,216,286,232,"1672",0,0,0
"7701",7701,101,454,801,556,"1674",0,0,0
"7702",7702,118,1304,2187,1432,"1676",525,233,292
"7703",7703,62,353,552,418,"1677",335,231,104
"7704",7704,157,428,813,592,"1678",50,12,38
"7705",7705,233,490,1199,727,"1679",0,0,0
"7706",7706,155,762,1381,927,"1684",506,370,136
"7707",7707,241,929,1813,1183,"1701",1502,713,789
"7708",7708,51,247,448,299,"1704",2720,1801,919
"7709",7709,150,598,1191,755,"1710",2137,1064,1073
"7710",7710,103,544,1012,654,"1714",4878,1327,3551
"7711",7711,510,352,1696,867,"1715",1250,550,700
"7712",7712,121,797,1323,926,"1717",3102,1467,1635
"7713",7713,3,40,62,46,"1718",1159,485,674
"7714",7714,22,140,272,164,"1719",2991,2223,768
"7715",7715,18,106,234,128,"1722",463,193,270
"7716",7716,3,79,105,84,"1723",2091,746,1345
"7717",7717,8,99,160,109,"2002",0,0,0
"7718",7718,13,135,233,151,"2003",990,707,283
"7719",7719,24,286,452,318,"2007",2286,1690,596
"7720",7720,299,421,488,741,"2026",2476,1620,856
"7721",7721,302,103,792,414,"2027",2214,472,1742
"7722",7722,521,1203,2390,1774,"2028",1411,1050,361
"7723",7723,476,543,1810,1037,"2029",2691,1600,1091
"7724",7724,413,2512,4170,2983,"2030",4842,1216,3626
"7725",7725,105,585,1007,706,"2031",7166,1549,5617
"7726",7726,325,970,2018,1322,"2033",3562,1663,1899
"7727",7727,214,787,1462,1007,"2052",7857,2897,4960
"7728",7728,114,64,309,182,"2055",2232,1421,811
"7729",7729,852,907,2799,1781,"2058",4,4,0
"7730",7730,750,202,2020,978,"2100",845,351,494
"7731",7731,810,124,1706,961,"2112",2014,1604,410
"7732",7732,817,47,1581,880,"2134",2678,356,2322
"7733",7733,421,785,1883,1237,"2143",1660,479,1181
"7734",7734,380,2362,3483,2778,"2145",4179,684,3495
"7735",7735,625,113,1247,748,"2147",1531,1047,484
"7736",7736,113,848,1403,975,"2148",6220,1110,5110
"7737",7737,657,53,2110,725,"2158A",3096,1552,1544
"7738",7738,401,2309,3840,2777,"2158B",0,0,0
"7739",7739,205,105,654,318,"2161",4589,1695,2894
"7740",7740,328,832,1586,1199,"2168",4427,1554,2873
"7741",7741,123,71,409,196,"2169",4111,411,3700
"7742",7742,508,1098,2369,1648,"2171",3139,2195,944
"7743",7743,300,1109,2050,1435,"2173",1031,735,296
"7744",7744,412,1168,2170,1612,"2174",3664,1897,1767
"7745",7745,332,1618,2799,1978,"2180",3546,466,3080
"7746",7746,473,778,1930,1287,"2181",3288,2139,1149
"7747",7747,473,2077,3714,2601,"2190",480,193,287
"7748",7748,328,1045,2136,1412,"2205",2807,1988,819
"7749",7749,550,2525,4278,3126,"2210",1795,287,1508
"7750",7750,451,2121,3622,2608,"2217",5186,1816,3370
"7751",7751,154,590,1084,756,"2219",2663,1611,1052
"7752",7752,144,681,1077,840,"2220",2647,1843,804
"7753",7753,584,178,1173,767,"2221",1802,911,891
"7754",7754,940,738,2703,1703,"2223",1851,1387,464
"7755",7755,1253,389,3181,1679,"2224",3211,1009,2202
"7756",7756,285,1158,1870,1463,"2225",5104,426,4678
"7757",7757,644,1186,2723,1882,"2226",3654,727,2927
"7758",7758,165,75,368,243,"2228",2340,1704,636
"7759",7759,488,2227,3553,2771,"2229",2939,1617,1322
"7760",7760,477,2580,4143,3104,"2235",6107,1178,4929
"7761",7761,599,2420,4034,3073,"2246",1173,903,270
"7762",7762,335,636,1402,1014,"2258",999,580,419
"7763",7763,972,1560,3890,2571,"2262",1327,894,433
"7764",7764,178,1259,1930,1462,"2263",4653,873,3780
"7765",7765,202,545,1210,758,"2266",3228,2330,898
"7766",7766,101,189,460,293,"2267",4227,1160,3067
"7767",7767,249,274,1054,542,"2268",2252,688,1564
"7768",7768,129,720,1213,871,"2269",717,172,545
"7769",7769,492,1310,2454,1847,"2274A",12,0,12
"7770",7770,748,1228,3161,2025,"2274B",0,0,0
"7771",7771,272,1356,2177,1649,"2275",1280,328,952
"7772",7772,130,134,431,271,"2280",2026,1352,674
"7773",7773,648,1592,3269,2288,"2281",1798,987,811
"7774",7774,575,925,2406,1538,"2299",2259,341,1918
"7775",7775,663,1698,3395,2443,"2302",3099,400,2699
"7776",7776,68,322,549,396,"2303",2838,1623,1215
"7777",7777,734,2197,3883,2981,"2304",2296,1572,724
"7778",7778,669,1956,3520,2667,"2305",2215,1275,940
"7779",7779,183,175,801,363,"2306",2061,1521,540
"7780",7780,663,786,2450,1503,"2307",3915,2240,1675
"7781",7781,202,231,721,441,"2308",4644,2365,2279
"7782",7782,687,2363,3854,3098,"2309",3560,686,2874
"7783",7783,192,196,652,393,"2310",2781,1469,1312
"7784",7784,80,307,517,398,"2313",2384,1673,711
"7785",7785,330,2103,3293,2466,"2314",3700,2656,1044
"7786",7786,267,127,1048,405,"2315",3070,819,2251
"7787",7787,205,278,752,494,"2316",2707,1285,1422
"7788",7788,589,2080,3659,2720,"2317",1354,898,456
"7789",7789,92,64,261,160,"2318",2208,1388,820
"7790",7790,26,41,67,68,"2319",2695,1838,857
"7791",7791,123,721,1150,865,"2320",3189,571,2618
"7792",7792,171,939,1561,1135,"2341",568,126,442
"7793",7793,217,1146,1801,1384,"2349",1999,500,1499
"7794",7794,184,933,1636,1146,"2353",1844,514,1330
"7795",7795,196,1087,1706,1302,"2354",3093,880,2213
"7796",7796,557,473,1972,1047,"2355",1932,1095,837
"7797",7797,791,671,3090,1514,"2356",4004,1897,2107
"7798",7798,585,570,2339,1199,"2357",3280,2024,1256
"7799",7799,169,193,613,370,"2358",2640,1789,851
"7800",7800,33,37,116,70,"2360",3898,2734,1164
"7801",7801,1197,957,4146,2233,"2379",4489,899,3590
"7802",7802,260,239,888,516,"2381",1489,235,1254
"7803",7803,1005,950,3808,2053,"2383",3192,990,2202
"7804",7804,534,521,2039,1097,"2393",742,154,588
"7805",7805,641,625,2524,1298,"2401",768,400,368
"7806",7806,1174,924,3982,2159,"2402",88,39,49
"7807",7807,888,866,3459,1785,"2403",189,37,152
"7808",7808,688,635,2809,1341,"2405",5211,1322,3889
"7809",7809,577,563,2221,1184,"2411",1351,190,1161
"7810",7810,76,623,1089,707,"2413",992,127,865
"7811",7811,103,938,1471,1053,"2419",0,0,0
"7812",7812,107,622,1247,738,"2425",4287,1908,2379
"7813",7813,97,975,1544,1078,"2426",2588,1685,903
"7814",7814,14,227,304,243,"2428",1601,207,1394
"7815",7815,11,128,186,140,"2435",3403,1702,1701
"7816",7816,3,32,44,35,"2438",4102,969,3133
"7817",7817,10,76,155,86,"2442",3468,1659,1809
"7818",7818,0,0,0,0,"2448",4031,1071,2960
"7819",7819,1,4,9,5,"2449",2935,698,2237
"7820",7820,1,11,20,12,"2450",3537,730,2807
"7821",7821,3,14,29,17,"2451",351,112,239
"7822",7822,8,177,262,186,"2453",3349,938,2411
"7823",7823,14,142,228,158,"2461",4181,628,3553
"7824",7824,16,161,245,180,"2462",2423,671,1752
"7825",7825,31,163,245,197,"2464",450,291,159
"7826",7826,24,155,216,180,"2466",1522,427,1095
"7827",7827,45,136,245,184,"2467",4265,1523,2742
"7828",7828,100,228,551,338,"2468",2698,1562,1136
"7829",7829,57,364,629,427,"2474",925,583,342
"7830",7830,87,393,681,486,"2484",6161,1123,5038
"7831",7831,78,237,581,318,"2488",2945,647,2298
"7832",7832,66,262,559,338,"2505",1945,1201,744
"7833",7833,120,429,970,554,"2506",5262,3422,1840
"7834",7834,99,378,725,486,"2513",0,0,0
"7835",7835,68,158,515,232,"2519",1422,431,991
"7836",7836,36,150,358,189,"2520",2205,1211,994
"7837",7837,36,286,449,327,"2521",1572,931,641
"7838",7838,5,23,35,28,"2522",5299,2971,2328
"7839",7839,48,159,322,211,"2523",2160,511,1649
"7840",7840,722,585,1888,1329,"2524",2246,1862,384
"7841",7841,940,694,2349,1660,"2525",4265,938,3327
"7842",7842,403,29,780,439,"2535",2427,1577,850
"7843",7843,144,28,290,175,"2536",2358,1046,1312
"7844",7844,423,585,1413,1028,"2537",3532,813,2719
"7845",7845,145,42,475,193,"2541",2817,652,2165
"7846",7846,423,71,1052,503,"2546",338,52,286
"7847",7847,1028,540,2349,1588,"2548",1675,1217,458
"7848",7848,1125,211,2298,1354,"2553",2089,610,1479
"7849",7849,229,164,670,396,"2556",1986,1451,535
"7850",7850,480,232,1196,730,"2557",1684,354,1330
"7851",7851,287,120,788,410,"2561",0,0,0
"7852",7852,782,1388,2945,2214,"2569",520,27,493
"7853",7853,435,439,1218,897,"2571",0,0,0
"7854",7854,1479,1255,3986,2776,"2581",3054,1018,2036
"7855",7855,1011,1379,3693,2433,"2600",0,0,0
"7856",7856,840,364,2031,1220,"2601",0,0,0
"7857",7857,605,1864,3338,2503,"2606",28,10,18
"7858",7858,170,60,1811,236,"2609",0,0,0
"7859",7859,283,88,681,377,"2612",0,0,0
"7860",7860,144,27,344,173,"2613",1849,310,1539
"7861",7861,17,5,32,22,"2614",332,107,225
"7862",7862,0,0,0,0,"2616",13,1,12
"7863",7863,364,178,988,549,"2618",47,21,26
"7864",7864,1051,465,2861,1561,"2635",2293,485,1808
"7865",7865,335,55,1012,395,"2636",3693,2108,1585
"7866",7866,367,99,1007,475,"2643",3905,1357,2548
"7867",7867,537,310,1050,865,"2644",3990,1060,2930
"7868",7868,448,39,839,489,"2645",2178,1403,775
"7869",7869,504,65,1146,572,"2655",1915,730,1185
"7870",7870,597,52,1326,659,"2656",248,90,158
"7871",7871,197,292,767,496,"2657",80,21,59
"7872",7872,263,121,633,391,"2658",1000,217,783
"7873",7873,433,97,1016,533,"2659",26,10,16
"7874",7874,0,0,0,0,"2660",541,156,385
"7875",7875,259,170,819,434,"2670",234,97,137
"7876",7876,527,144,1277,679,"2673",0,0,0
"7877",7877,705,40,1351,752,"2675",15,0,15
"7878",7878,715,75,1691,798,"2680",0,0,0
"7879",7879,746,376,1785,1141,"2681",0,0,0
"7880",7880,290,364,805,670,"2697",4254,1694,2560
"7881",7881,776,92,1807,871,"2699",4337,1289,3048
"7882",7882,324,115,895,440,"2708",2047,797,1250
"7883",7883,431,737,1523,1187,"2712",3319,1474,1845
"7884",7884,1363,149,2592,1520,"2721",2607,1557,1050
"7885",7885,627,619,1615,1267,"2726",2986,758,2228
"7886",7886,1161,63,2215,1236,"2727",629,445,184
"7887",7887,789,606,1851,1418,"3032",1758,1091,667
"7888",7888,509,246,1276,769,"3035",3643,2899,744
"7889",7889,715,1939,3306,2697,"3036",3452,1526,1926
"7890",7890,731,710,1918,1462,"3037",3029,2331,698
"7891",7891,1732,808,3825,2584,"3038",6035,2881,3154
"7892",7892,1485,112,2827,1614,"3039",1741,1418,323
"7893",7893,864,363,1700,1239,"3040",3931,2934,997
"7894",7894,802,48,1428,854,"3041",4496,2280,2216
"7895",7895,773,64,1765,844,"3043",3571,2593,978
"7896",7896,758,565,1907,1349,"3049",3131,2514,617
"7897",7897,479,449,1302,952,"3054",3955,2824,1131
"7898",7898,1146,555,2475,1719,"3063",1858,1445,413
"7899",7899,1222,321,2919,1552,"3072",2718,2203,515
"7900",7900,742,278,1687,1022,"3114",4134,2730,1404
"7901",7901,515,305,1301,829,"3131",2463,1592,871
"7902",7902,951,91,1652,1058,"3139",2052,1092,960
"7903",7903,313,67,841,384,"3140",2201,1585,616
"7904",7904,100,52,223,155,"3152",52,39,13
"7905",7905,607,482,1604,1120,"3156",1734,1339,395
"7906",7906,1163,605,2735,1800,"3157",3469,1918,1551
"7907",7907,764,565,1845,1352,"3160",4685,1735,2950
"7908",7908,321,271,1000,602,"3164",2950,1841,1109
"7909",7909,263,399,796,665,"3166",5173,1984,3189
"7910",7910,320,9,608,331,"3172",3840,2268,1572
"7911",7911,1009,810,2473,1855,"3176",5050,2930,2120
"7912",7912,1596,1514,4299,3191,"3177",2664,2117,547
"7913",7913,141,107,510,251,"3183",4999,2246,2753
"7914",7914,154,191,421,350,"3185",0,0,0
"7915",7915,704,1276,2807,2020,"3187",2004,1322,682
"7916",7916,1003,724,2601,1772,"3192",1110,809,301
"7917",7917,529,1084,2006,1642,"3193",3132,2478,654
"7918",7918,1138,92,2394,1246,"3194",3146,1804,1342
"7919",7919,691,250,1467,951,"3196",2226,1764,462
"7920",7920,258,165,616,432,"3200",3125,2031,1094
"7921",7921,324,141,893,473,"3209",3877,3161,716
"7922",7922,1346,676,3151,2040,"3212",3010,1741,1269
"7923",7923,120,52,348,173,"3213",2348,1556,792
"7924",7924,30,90,167,120,"3214",3920,2277,1643
"7925",7925,1376,331,2835,1732,"3215",2635,2007,628
"7926",7926,1527,711,3334,2275,"3216",4585,2543,2042
"7927",7927,714,338,1648,1070,"3240",3656,1998,1658
"7928",7928,655,647,1794,1329,"3247",3205,1321,1884
"7929",7929,929,571,2181,1517,"3248",3983,3190,793
"7930",7930,200,182,671,388,"3249",4869,2601,2268
"7931",7931,596,1375,2956,2008,"3254",3257,1863,1394
"7932",7932,859,461,2450,1353,"3260",1606,1267,339
"7933",7933,581,448,1454,1042,"3282",1956,1421,535
"7934",7934,1153,242,2434,1403,"3283",1762,1305,457
"7935",7935,1097,343,2239,1462,"3286",985,738,247
"7936",7936,1128,69,2029,1213,"3287",3273,2108,1165
"7937",7937,780,237,1829,1039,"3289",3960,2248,1712
"7938",7938,683,154,1496,845,"3321",3414,2381,1033
"7939",7939,916,1292,3147,2237,"3322",2117,1676,441
"7940",7940,349,172,936,531,"3323",3324,2624,700
"7941",7941,967,1067,2874,2062,"3324",3160,2096,1064
"7942",7942,1450,96,2884,1561,"3325",1372,896,476
"7943",7943,965,778,2518,1772,"3326",1492,967,525
"7944",7944,1157,521,2612,1709,"3327",1698,1233,465
"7945",7945,1160,210,2132,1386,"3329",4143,1709,2434
"7946",7946,1030,289,1951,1336,"3330",1120,909,211
"7947",7947,676,1239,2461,1943,"3331",4344,3288,1056
"7948",7948,1003,1066,3005,2102,"3332",4463,2235,2228
"7949",7949,178,159,481,339,"3333",6490,4357,2133
"7950",7950,459,31,1212,498,"3334",2893,1773,1120
"7951",7951,1691,1070,3874,2808,"3335",2554,1727,827
"7952",7952,201,543,923,756,"3336",5203,1813,3390
"7953",7953,0,0,0,0,"3359",2068,1605,463
"7954",7954,134,336,676,470,"3361",3665,2727,938
"7955",7955,4,1,10,5,"3363",3522,2298,1224
"7956",7956,12,4,61,18,"3364",1526,860,666
"7957",7957,1560,1300,4203,2898,"3365",4089,3365,724
"7958",7958,1835,603,3873,2465,"3367",1858,1425,433
"7959",7959,737,413,1696,1179,"3368",809,646,163
"7960",7960,1309,376,2835,1713,"3372",4447,2681,1766
"7961",7961,1673,663,3734,2369,"3384",2057,1417,640
"7962",7962,0,0,0,0,"3385",2769,2208,561
"7963",7963,1199,420,2593,1648,"3386",2405,1972,433
"7964",7964,23,13,67,36,"3387",2141,1765,376
"7965",7965,101,42,236,148,"3389",5003,2664,2339
"7966",7966,0,0,0,0,"3390",3914,2915,999
"7967",7967,24,5,42,30,"3391",4669,2092,2577
"7968",7968,648,196,1833,852,"3392",2244,1792,452
"7969",7969,67,56,152,123,"3396",3430,2455,975
"7970",7970,0,0,0,0,"3398",1963,1339,624
"7971",7971,0,0,0,0,"3406",0,0,0
"7972",7972,795,1400,2621,2213,"3409",144,45,99
"7973",7973,1,7,12,8,"3417",3149,1765,1384
"7974",7974,1,3,9,4,"3421",1429,1183,246
"7975",7975,5,2,13,7,"3422",2474,1628,846
"7976",7976,461,1122,2188,1595,"3433",709,553,156
"7977",7977,0,0,1,0,"3443",2500,1713,787
"7978",7978,588,311,1337,911,"3446",0,0,0
"7979",7979,230,215,601,447,"3447",0,0,0
"7980",7980,115,18,246,135,"3465",4597,2697,1900
"7981",7981,1011,272,2209,1302,"3469A",1203,1018,185
"7982",7982,374,77,911,458,"3469B",0,0,0
"7983",7983,47,11,97,59,"3470",195,99,96
"7984",7984,26,5,43,31,"3471",1705,1411,294
"7985",7985,0,0,0,0,"3486",4323,2846,1477
"7986",7986,1,1,4,3,"3500",548,436,112
"7987",7987,967,338,1954,1321,"3502",1463,1259,204
"7988",7988,1338,363,3329,1735,"3507",3181,2049,1132
"7989",7989,859,276,2351,1156,"3509",2646,1737,909
"7990",7990,55,96,229,155,"3510",2810,2261,549
"7991",7991,43,26,144,73,"3511",4425,1958,2467
"7992",7992,39,29,122,71,"3516",1949,1582,367
"7993",7993,500,84,1267,595,"3517",3956,2159,1797
"7994",7994,81,33,206,115,"3526",1225,924,301
"7995",7995,202,76,586,282,"3527",2745,2062,683
"7996",7996,291,68,746,363,"3529",2583,1686,897
"7997",7997,1036,364,2149,1423,"3530",2965,2137,828
"7998",7998,336,125,772,466,"3538",3718,2549,1169
"7999",7999,2,1,4,3,"3539",27,17,10
"8000",8000,231,136,589,373,"3542",2703,1911,792
"8001",8001,326,1170,2089,1524,"3545",2392,1806,586
"8002",8002,0,0,0,0,"3552",4814,2500,2314
"8003",8003,8,11,37,19,"3554",2994,2337,657
"8004",8004,452,105,1079,563,"3558",3313,2576,737
"8005",8005,506,123,1042,638,"3560",0,0,0
"8006",8006,3,0,10,4,"3562",135,116,19
"8007",8007,0,0,0,0,"3566",0,0,0
"8008",8008,0,0,0,0,"3567",4978,3533,1445
"8009",8009,26,0,49,27,"3570",3969,2270,1699
"8010",8010,0,0,5,0,"3574",1480,721,759
"8011",8011,112,36,238,151,"3575",10,3,7
"8012",8012,0,0,0,0,"3579",932,724,208
"8013",8013,91,6,185,99,"3580",0,0,0
"8014",8014,542,122,1187,673,"3582",85,41,44
"8015",8015,691,216,1551,923,"3583",0,0,0
"8016",8016,2,2,14,4,"3584",0,0,0
"8017",8017,77,72,239,154,"3585",28,7,21
"8018",8018,0,0,0,0,"3590",0,0,0
"8019",8019,223,61,603,294,"3624",380,194,186
"8020",8020,0,0,0,0,"3626",898,746,152
"8021",8021,0,0,0,0,"3637",3209,1577,1632
"8022",8022,0,0,0,0,"3646",4346,2695,1651
"8023",8023,442,275,900,736,"3647",4990,3025,1965
"8024",8024,15,14,39,29,"3648",4177,2613,1564
"8025",8025,11,7,31,18,"3653",0,0,0
"8026",8026,17,11,42,28,"3654",0,0,0
"8027",8027,12,4,34,16,"3661",0,0,0
"8028",8028,117,39,254,157,"3662",21,13,8
"8029",8029,11,21,46,32,"3663",10,2,8
"8030",8030,0,0,0,0,"3664",0,0,0
"8031",8031,0,0,0,0,"3665",12,10,2
"8032",8032,58,156,345,221,"3667",145,82,63
"8033",8033,119,71,288,190,"3668",355,272,83
"8034",8034,11,13,36,24,"3669",8,5,3
"8035",8035,669,179,1256,854,"3671",797,627,170
"8036",8036,1819,1089,3888,2958,"3695",4189,2741,1448
"8037",8037,1197,474,2542,1697,"3696",4808,2918,1890
"8038",8038,0,0,0,0,"3698",3982,2235,1747
"8039",8039,98,5,265,104,"3700",2934,1863,1071
"8040",8040,0,0,0,0,"3706",4395,2603,1792
"8041",8041,0,0,0,0,"3709",1560,1033,527
"8042",8042,113,69,340,190,"3716",2430,1773,657
"8043",8043,120,47,185,172,"3720",2147,1821,326
"8044",8044,1,2,22,3,"3725",2957,1973,984
"8045",8045,0,0,0,0,"3728",2749,1633,1116
"8046",8046,186,140,451,337,"3729",5,3,2
"8047",8047,461,400,1205,874,"4006",1586,783,803
"8048",8048,641,1016,2382,1690,"4016",1731,1319,412
"8049",8049,474,591,1706,1074,"4017",6273,682,5591
"8050",8050,1625,669,3593,2344,"4018",1565,971,594
"8051",8051,454,327,991,786,"4020",2976,1673,1303
"8052",8052,665,713,2066,1402,"4042",2499,865,1634
"8053",8053,502,346,1147,862,"4044A",4613,2843,1770
"8054",8054,741,1302,2802,2089,"4044B",0,0,0
"8055",8055,179,126,433,309,"4045",2710,2233,477
"8056",8056,861,434,1612,1314,"4046",5109,4243,866
"8057",8057,1784,501,3377,2308,"4047",4654,3829,825
"8058",8058,14,4,27,18,"4048",1548,121,1427
"8059",8059,43,14,96,58,"4050",3108,264,2844
"8060",8060,0,0,0,0,"4051",12,5,7
"8061",8061,0,0,0,0,"4053",1688,1009,679
"8062",8062,0,0,0,0,"4057",915,635,280
"8063",8063,0,0,0,0,"4060",2637,1516,1121
"8064",8064,0,0,0,0,"4065",4635,3462,1173
"8065",8065,0,0,0,0,"4067",2289,155,2134
"8066",8066,0,0,0,0,"4068",2807,171,2636
"8067",8067,0,0,0,0,"4069",1983,1541,442
"8068",8068,340,369,963,721,"4070",2948,1620,1328
"8069",8069,709,999,2262,1736,"4073",843,357,486
"8070",8070,650,770,2099,1446,"4077",277,207,70
"8071",8071,237,144,662,389,"4086",2400,2121,279
"8072",8072,350,631,1368,996,"4087",1087,88,999
"8073",8073,721,1025,2413,1769,"4091",3540,2188,1352
"8074",8074,1702,529,3644,2262,"4092",2029,105,1924
"8075",8075,1298,549,2629,1864,"4093",3667,273,3394
"8076",8076,744,790,2691,1564,"4096",1143,778,365
"8077",8077,916,544,2377,1502,"4097",1792,350,1442
"8078",8078,789,734,2061,1557,"4101",2422,527,1895
"8079",8079,7,3,16,10,"4102",2432,746,1686
"8080",8080,203,165,583,377,"4107",2069,168,1901
"8081",8081,517,1017,2046,1554,"4110",1525,166,1359
"8082",8082,342,243,1207,591,"4113",2398,1280,1118
"8083",8083,311,228,938,552,"4115",586,531,55
"8084",8084,755,354,2144,1122,"4116",2252,1826,426
"8085",8085,428,454,1282,901,"4118",1937,1110,827
"8086",8086,1019,436,2908,1481,"4121",3595,1788,1807
"8087",8087,803,881,2392,1703,"4122",4006,378,3628
"8088",8088,657,282,1701,965,"4123",3798,242,3556
"8089",8089,403,273,1166,693,"4124",1179,834,345
"8090",8090,427,166,1221,600,"4125",1256,433,823
"8091",8091,915,1064,2766,2028,"4128",4828,2886,1942
"8092",8092,300,511,1000,822,"4129",1077,941,136
"8093",8093,1007,955,2939,1994,"4130",2286,1977,309
"8094",8094,797,236,1983,1042,"4135",1905,1053,852
"8095",8095,972,1014,2760,2019,"4136",4477,1931,2546
"8096",8096,116,94,355,214,"4137",1487,1263,224
"8097",8097,768,1026,2517,1842,"4138",1774,612,1162
"8098",8098,383,188,1116,578,"4141",6110,2561,3549
"8099",8099,1236,685,3343,1952,"4144",2056,1306,750
"8100",8100,899,989,2544,1910,"4155",5492,710,4782
"8101",8101,908,1118,2626,2052,"4159",3038,1040,1998
"8102",8102,696,644,1805,1360,"4162",1317,252,1065
"8103",8103,487,966,1863,1476,"4163",1192,1003,189
"8104",8104,893,394,2198,1308,"4178",4733,2828,1905
"8105",8105,762,234,2085,1014,"4179",2326,1035,1291
"8106",8106,818,439,2236,1280,"4182",3537,2637,900
"8107",8107,824,1067,2381,1914,"4191",1839,964,875
"8108",8108,770,774,2331,1570,"4195",3075,213,2862
"8109",8109,1117,636,3229,1768,"4201",1882,55,1827
"8110",8110,416,510,1179,949,"4202",2896,1002,1894
"8111",8111,154,324,688,483,"4203",4600,1364,3236
"8112",8112,212,526,1067,750,"4204",5993,3310,2683
"8113",8113,808,463,2473,1293,"4218",2424,806,1618
"8114",8114,963,1281,3068,2276,"4222",1760,649,1111
"8115",8115,938,413,2533,1371,"4230",4569,3417,1152
"8116",8116,525,404,1538,943,"4231",3201,216,2985
"8117",8117,180,130,511,314,"4232",5468,2086,3382
"8118",8118,0,2,3,2,"4233",2689,629,2060
"8119",8119,395,285,1055,691,"4234",3363,2275,1088
"8120",8120,569,533,1492,1118,"4239",257,124,133
"8121",8121,583,525,1512,1122,"4242",845,624,221
"8122",8122,918,412,1920,1349,"4243",2954,1490,1464
"8123",8123,801,215,1879,1025,"4245A",347,25,322
"8124",8124,764,876,2240,1668,"4245B",0,0,0
"8125",8125,724,1045,2303,1791,"4245C",0,0,0
"8126",8126,659,717,1959,1403,"4250",5942,2962,2980
"8127",8127,592,896,2017,1516,"4252",1311,797,514
"8128",8128,1390,1428,3741,2867,"4253",935,656,279
"8129",8129,1170,1288,3662,2497,"4256",1988,152,1836
"8130",8130,561,348,1771,925,"4259",1181,1003,178
"8131",8131,630,691,1978,1344,"4261",4489,2079,2410
"8132",8132,703,1039,2365,1766,"4272",826,599,227
"8133",8133,1030,1424,3400,2498,"4276",2908,1673,1235
"8134",8134,875,342,2035,1239,"4284",299,243,56
"8135",8135,804,519,1980,1347,"4285",2292,992,1300
"8136",8136,450,529,1320,1002,"4288",709,27,682
"8137",8137,560,754,1912,1332,"4290",3759,1820,1939
"8138",8138,703,1070,2501,1802,"4312",190,74,116
"8139",8139,810,431,2198,1252,"4328",3200,1304,1896
"8140",8140,243,75,486,322,"4338",5057,2597,2460
"8141",8141,814,486,1813,1310,"4340",2962,2465,497
"8142",8142,555,295,1388,861,"4342",2482,1909,573
"8143",8143,631,359,1656,1008,"4343",2684,2121,563
"8144",8144,519,672,1712,1212,"4344",1522,1286,236
"8145",8145,1178,1085,3245,2298,"4350",1607,1227,380
"8146",8146,1004,1447,3244,2487,"4362",11,5,6
"8147",8147,790,1043,2491,1856,"4369",4209,2833,1376
"8148",8148,903,1730,3463,2669,"4370",0,0,0
"8149",8149,1863,765,3853,2655,"4371",2582,2111,471
"8150",8150,294,95,782,392,"4373",336,257,79
"8151",8151,1046,560,2548,1634,"4374",2667,1482,1185
"8152",8152,146,99,449,245,"4375",3388,2412,976
"8153",8153,94,110,401,207,"4395",977,806,171
"8154",8154,7,10,45,17,"4397",647,316,331
"8155",8155,12,1,46,13,"4399",290,216,74
"8156",8156,2175,912,4593,3120,"4400",671,333,338
"8157",8157,253,68,700,323,"4410",4363,1879,2484
"8158",8158,359,135,748,500,"4429",2837,1524,1313
"8159",8159,0,0,0,0,"4432",251,151,100
"8160",8160,1258,936,3361,2231,"4452",4553,1689,2864
"8161",8161,711,1097,2502,1829,"4454",3593,2085,1508
"8162",8162,238,89,695,330,"4456",1178,938,240
"8163",8163,1153,1115,3014,2292,"4458",0,0,0
"8164",8164,1282,525,2898,1831,"4475",57,42,15
"8165",8165,1453,1025,2924,2510,"4478",0,0,0
"8166",8166,1356,675,3280,2067,"4480",961,766,195
"8167",8167,674,361,1651,1051,"4483",110,20,90
"8168",8168,1141,624,2782,1779,"4485",1125,240,885
"8169",8169,73,25,198,98,"4487",0,0,0
"8170",8170,1326,532,2547,1877,"4492",2271,1540,731
"8171",8171,1034,314,2470,1374,"4493",2813,2009,804
"8172",8172,807,376,1829,1203,"4494",219,115,104
"8173",8173,165,197,467,370,"4495",228,84,144
"8174",8174,582,266,1314,861,"4496",1173,431,742
"8175",8175,1257,549,2954,1825,"4497",6512,2269,4243
"8176",8176,874,948,2540,1852,"4498",518,463,55
"8177",8177,127,244,587,376,"4499",6234,2452,3782
"8178",8178,1850,938,4244,2814,"4503",1895,407,1488
"8179",8179,1165,618,2572,1798,"4508",5523,2728,2795
"8180",8180,474,699,1644,1186,"4512",0,0,0
"8181",8181,1500,1855,4702,3408,"4528",4440,2512,1928
"8182",8182,0,0,0,0,"4531",3551,2227,1324
"8183",8183,541,252,1221,803,"4532",1321,1139,182
"8184",8184,757,716,2105,1498,"4533",2486,986,1500
"8185",8185,419,550,1473,990,"4534",5155,3098,2057
"8186",8186,1206,1416,3610,2657,"4540",4456,2140,2316
"8187",8187,1399,706,3193,2131,"4551",5089,2749,2340
"8188",8188,524,1378,2386,1923,"4563",0,0,0
"8189",8189,1595,564,3265,2191,"4565",75,26,49
"8190",8190,1003,1437,3147,2474,"4568",85,56,29
"8191",8191,821,555,1976,1395,"4572",41,2,39
"8192",8192,728,253,1917,997,"4573",16,3,13
"8193",8193,1128,513,2495,1661,"4587",407,8,399
"8194",8194,24,13,121,37,"4588",4648,2654,1994
"8195",8195,436,842,1717,1297,"4591",3600,1793,1807
"8196",8196,641,358,1653,1017,"4592",0,0,0
"8197",8197,600,819,1890,1447,"4593",1165,314,851
"8198",8198,718,282,1430,1014,"4595",154,54,100
"8199",8199,0,0,0,0,"4596",211,28,183
"8200",8200,34,12,125,47,"4598",0,0,0
"8201",8201,0,0,0,0,"4599",6255,3062,3193
"8202",8202,1062,647,2637,1729,"4602",0,0,0
"8203",8203,0,0,0,0,"4604",15,0,15
"8204",8204,0,0,0,0,"4615",0,0,0
"8205",8205,9,4,19,14,"4620",364,85,279
"8206",8206,0,0,0,0,"4629",0,0,0
"8207",8207,0,0,0,0,"4630",0,0,0
"8208",8208,1528,552,3070,2101,"4632",0,0,0
"8209",8209,169,88,321,258,"4634",1801,1269,532
"8210",8210,40,22,163,62,"4638",3718,1993,1725
"8211",8211,27,7,47,35,"4640",962,502,460
"8212",8212,891,364,1930,1268,"4649",4032,2406,1626
"8213",8213,752,1017,2812,1805,"4650",3782,1879,1903
"8214",8214,1801,1047,3919,2890,"4666",0,0,0
"8215",8215,1871,739,3452,2641,"4682",720,141,579
"8216",8216,650,1030,2222,1704,"4683",0,0,0
"8217",8217,458,268,1351,748,"4685A",8,1,7
"8218",8218,44,19,158,63,"4685B",0,0,0
"8219",8219,16,4,41,20,"4686",0,0,0
"8220",8220,207,86,553,296,"4687",514,114,400
"8221",8221,7,5,26,12,"4688",105,26,79
"8222",8222,71,94,318,170,"4689",247,96,151
"8223",8223,51,36,156,87,"4690",23,10,13
"8224",8224,0,0,0,0,"4691",41,13,28
"8225",8225,0,0,0,0,"4692",56,19,37
"8226",8226,0,0,0,0,"4693",23,3,20
"8227",8227,0,0,0,0,"4694",5785,3208,2577
"8228",8228,1330,856,3038,2205,"4702",1836,1002,834
"8229",8229,1865,938,3630,2829,"4703",3852,1590,2262
"8230",8230,857,502,1863,1375,"4705",3748,1576,2172
"8231",8231,1212,1018,3157,2259,"4707",2402,991,1411
"8232",8232,685,1028,2319,1733,"4711",3049,1183,1866
"8233",8233,1079,593,2453,1682,"4713",3892,1999,1893
"8234",8234,234,244,640,483,"4724",1146,896,250
"8235",8235,874,364,1770,1251,"0101",4632,2746,1886
"8236",8236,72,43,200,115,"0102",3360,2198,1162
"8237",8237,209,128,580,341,"0103",3474,2133,1341
"8238",8238,4,1,9,5,"0104",2535,2113,422
"8239",8239,105,44,268,151,"0105",6062,3406,2656
"8240",8240,71,68,190,143,"0106",3202,1888,1314
"8241",8241,498,345,1460,871,"0107",935,670,265
"8242",8242,0,0,0,0,"0108",1363,1123,240
"8243",8243,0,0,0,0,"0109",326,285,41
"8244",8244,0,0,0,0,"0110",106,98,8
"8245",8245,0,0,0,0,"0201",3079,1230,1849
"8246",8246,0,0,0,0,"0202",5286,1813,3473
"8247",8247,0,0,0,0,"0203",4016,1790,2226
"8248",8248,380,618,1407,1024,"0204",2315,1593,722
"8249",8249,1159,1837,3761,3052,"0205",5366,2439,2927
"8250",8250,746,726,2389,1499,"0206",3089,2458,631
"8251",8251,849,1363,2889,2243,"0207",386,313,73
"8252",8252,1194,1241,3664,2493,"0301",4038,2561,1477
"8253",8253,484,1000,1857,1505,"0302",2853,2141,712
"8254",8254,794,1606,3439,2445,"0303",2057,1802,255
"8255",8255,1413,1810,5143,3292,"0304",4203,2691,1512
"8256",8256,739,1835,3508,2621,"0305",3186,2473,713
"8257",8257,743,1711,3095,2482,"0306",5673,4319,1354
"8258",8258,1038,1657,3696,2738,"0307",6705,5195,1510
"8259",8259,473,925,1823,1418,"0308",1779,1548,231
"8260",8260,608,1500,2782,2148,"0401",2645,1550,1095
"8261",8261,850,1338,3154,2230,"0402",5131,3661,1470
"8262",8262,449,830,1818,1297,"0403",3907,2395,1512
"8263",8263,430,523,1551,977,"0404",3076,1876,1200
"8264",8264,468,859,1903,1354,"0405",2454,1465,989
"8265",8265,6,26,49,33,"0406",4607,3212,1395
"8266",8266,432,904,1779,1357,"0407",1650,1190,460
"8267",8267,767,860,2593,1664,"0408",4116,3377,739
"8268",8268,902,845,2775,1763,"0409",953,779,174
"8269",8269,550,828,2156,1401,"0001",153,66,87
"8270",8270,879,824,2814,1742,"0002A",26,22,4
"8271",8271,791,1042,2787,1877,"0002B",129,24,105
"8272",8272,1091,1395,3642,2537,"0003",142,84,58
"8273",8273,586,1365,2578,1984,"0004A",32,32,0
"8274",8274,1392,1385,4013,2823,"0004B",134,83,51
"8275",8275,2,2,4,4,"0101",1000,538,462
"8276",8276,464,690,1703,1180,"0102",1718,984,734
"8277",8277,233,595,1048,834,"0201",1350,450,900
"8278",8278,844,1793,3244,2665,"0202",595,240,355
"8279",8279,587,882,2449,1500,"0301",1904,528,1376
"8280",8280,621,1116,2276,1775,"0401",1755,667,1088
"8281",8281,835,986,2612,1853,"0402",260,191,69
"8282",8282,1013,2314,4102,3366,"0001",284,264,20
"8283",8283,720,761,2215,1517,"0002",288,245,43
"8284",8284,542,742,1959,1312,"3003",284,256,28
"8285",8285,867,1269,3065,2171,"4005",94,88,6
"8286",8286,563,1194,2346,1778,"4006",178,150,28
"8287",8287,1490,1372,3896,2909,"0001",1025,104,921
"8288",8288,1013,1416,3415,2469,"0002",758,382,376
"8289",8289,654,559,1958,1245,"0003",857,566,291
"8290",8290,1104,2145,4128,3305,"0004",728,553,175
"8291",8291,1337,1271,3686,2656,"0005",279,248,31
"8292",8292,800,890,2568,1722,"0006",1402,911,491
"8293",8293,431,779,1567,1238,"0007",1428,945,483
"8294",8294,476,784,1721,1283,"0008",2378,401,1977
"8295",8295,505,837,1766,1363,"0009",649,412,237
"8296",8296,226,621,1063,857,"0010",1077,827,250
"8297",8297,712,1173,2769,1920,"0011",422,134,288
"8298",8298,682,1233,2976,1952,"0012",369,228,141
"8299",8299,809,1303,2889,2154,"0014",2542,974,1568
"8300",8300,655,1040,2120,1721,"0015",1257,692,565
"8301",8301,944,1951,3566,2942,"0016",3186,1862,1324
"8302",8302,653,1055,2489,1747,"0017",1061,191,870
"8303",8303,241,537,1153,795,"0018",319,146,173
"8304",8304,244,354,974,615,"0019",1194,507,687
"8305",8305,543,759,1740,1318,"0020",1724,871,853
"8306",8306,1156,895,2929,2085,"0106",2401,679,1722
"8307",8307,312,609,1178,934,"0107",690,320,370
"8308",8308,881,1772,3275,2686,"0108",1050,776,274
"8309",8309,916,1191,3393,2147,"0112",1095,748,347
"8310",8310,922,1361,3087,2308,"0114",1370,112,1258
"8311",8311,806,785,2289,1626,"0124",2500,503,1997
"8312",8312,721,1015,2296,1761,"0137",3703,1428,2275
"8313",8313,1596,1030,3575,2669,"0144",2521,889,1632
"8314",8314,721,1054,2296,1798,"0146",5944,1787,4157
"8315",8315,933,1395,3232,2371,"0213",2712,2254,458
"8316",8316,775,1664,3282,2472,"0215",3099,2012,1087
"8317",8317,339,405,1167,757,"0225",101,92,9
"8318",8318,1159,2327,4341,3530,"0228",4005,2631,1374
"8319",8319,470,860,1820,1356,"0230",8325,5057,3268
"8320",8320,208,415,793,631,"0241",5587,4303,1284
"8321",8321,1066,1627,3884,2762,"0304",4724,2238,2486
"8322",8322,578,718,1794,1321,"0305",76,37,39
"8323",8323,959,1496,3037,2508,"0306",2538,1284,1254
"8324",8324,564,1433,2554,2022,"0308",539,177,362
"8325",8325,519,1177,2199,1734,"0319",4090,2699,1391
"8326",8326,1638,1319,4086,3007,"0327",3934,1644,2290
"8327",8327,1217,2255,4245,3514,"0348",1056,575,481
"8328",8328,1235,812,3119,2088,"0351",374,303,71
"8329",8329,601,1272,2427,1903,"0358",6425,4533,1892
"8330",8330,1220,1491,3399,2783,"0401",218,119,99
"8331",8331,451,736,1750,1207,"0402",4243,2311,1932
"8332",8332,0,0,0,0,"0420",654,408,246
"8333",8333,5,14,42,19,"0421",3959,2550,1409
"8334",8334,765,1028,2538,1828,"0422",1238,1007,231
"8335",8335,377,827,1509,1228,"0423",1585,1243,342
"8336",8336,687,1265,2513,1977,"0424",2903,1716,1187
"8337",8337,158,347,617,511,"0434",1718,691,1027
"8338",8338,797,974,2404,1806,"0435",1887,860,1027
"8339",8339,0,1,0,1,"0436",4491,3063,1428
"8340",8340,0,0,0,0,"0101",12709,2698,10011
"8341",8341,1168,1480,3910,2693,"0102",2047,600,1447
"8342",8342,401,547,1178,966,"0103",2106,995,1111
"8343",8343,44,71,185,115,"0104",1814,669,1145
"8344",8344,479,1014,1824,1522,"0105",17981,4399,13582
"8345",8345,1210,1789,4147,3059,"0106",7003,2345,4658
"8346",8346,91,268,508,363,"0107",748,287,461
"8347",8347,331,987,1667,1330,"0108",2278,753,1525
"8348",8348,735,998,2605,1758,"0109",3402,1573,1829
"8349",8349,603,899,2237,1540,"0110",10939,4546,6393
"8350",8350,770,1702,3053,2513,"0111",6467,2765,3702
"8351",8351,1292,840,3175,2184,"0112",3926,1107,2819
"8352",8352,542,1021,1935,1589,"0113",16517,4375,12142
"8353",8353,876,811,2546,1704,"0114",295,111,184
"8354",8354,400,710,1365,1125,"0115",0,0,0
"8355",8355,726,1272,2662,2025,"0116",4,0,4
"8356",8356,854,1292,2751,2165,"0117",9558,1054,8504
"8357",8357,957,1232,2822,2240,"0118",2338,683,1655
"8358",8358,1287,1813,3937,3136,"0119",0,0,0
"8359",8359,0,7,11,7,"0120",393,199,194
"8360",8360,806,1009,2452,1855,"0121",2526,374,2152
"8361",8361,718,1325,2594,2071,"0122",4254,1025,3229
"8362",8362,1172,1268,3550,2484,"0123",10959,4902,6057
"8363",8363,818,1659,3193,2520,"0124",6760,2950,3810
"8364",8364,1012,1847,3586,2909,"0125",0,0,0
"8365",8365,0,0,0,0,"0126",6527,3510,3017
"8366",8366,32,84,133,117,"0127",0,0,0
"8367",8367,0,0,0,0,"0128",0,0,0
"8368",8368,625,1551,2777,2199,"0129",5081,1657,3424
"8369",8369,940,1239,3139,2220,"0130",2788,1236,1552
"8370",8370,370,294,888,673,"0131",19,6,13
"8371",8371,0,0,0,0,"0132",3723,1508,2215
"8372",8372,223,532,980,760,"0133",2827,1457,1370
"8373",8373,0,0,0,0,"0134",0,0,0
"8374",8374,2,30,40,34,"0135",9309,5616,3693
"8375",8375,0,0,0,0,"0136",3524,1846,1678
"8376",8376,0,0,0,0,"0137",14250,7232,7018
"8377",8377,0,0,0,0,"0138",0,0,0
"8378",8378,0,0,0,0,"0139",10577,1991,8586
"8379",8379,99,169,334,271,"0140",4041,834,3207
"8380",8380,200,413,757,616,"0141",1042,315,727
"8381",8381,847,848,2580,1727,"0142",2648,939,1709
"8382",8382,1015,1401,3605,2481,"0145",3483,1360,2123
"8383",8383,1168,1502,3558,2704,"0146",3472,1692,1780
"8384",8384,1149,1693,3994,2889,"0148",7983,2832,5151
"8385",8385,0,0,0,0,"0149",2232,1417,815
"8386",8386,0,0,0,0,"0150",2388,1529,859
"8387",8387,0,0,0,0,"0151",2839,1395,1444
"8388",8388,2,3,6,5,"0152",3841,2750,1091
"8389",8389,0,0,0,0,"0153",8550,3014,5536
"8390",8390,0,10,14,12,"0154",6629,2063,4566
"8391",8391,37,60,119,97,"0156",12299,3876,8423
"8392",8392,109,219,409,329,"0160",4301,1272,3029
"8393",8393,5,2,7,7,"0161",3455,1208,2247
"8394",8394,233,490,974,731,"0163",642,329,313
"8395",8395,1377,1854,4267,3281,"0164",6375,919,5456
"8396",8396,1242,1753,4100,3057,"0200",7129,4932,2197
"8397",8397,1240,1483,3785,2781,"0202",4265,2822,1443
"8398",8398,564,971,2397,1570,"0203",4300,1081,3219
"8399",8399,983,1039,3138,2072,"0205",4859,2093,2766
"8400",8400,426,621,1497,1071,"0206",2630,1578,1052
"8401",8401,648,1129,2291,1795,"0207",7979,3937,4042
"8402",8402,455,1345,2238,1826,"0208",8903,3113,5790
"8403",8403,683,1148,2612,1876,"0209",3670,579,3091
"8404",8404,848,1282,2702,2149,"0210",1697,1440,257
"8405",8405,271,260,774,534,"0211",3380,1353,2027
"8406",8406,432,1073,1924,1524,"0212",4226,3449,777
"8407",8407,360,743,1362,1112,"0213",0,0,0
"8408",8408,0,0,0,0,"0214",2707,2334,373
"8409",8409,0,0,0,0,"0215",3766,1589,2177
"8410",8410,0,0,0,0,"0216",5234,1853,3381
"8411",8411,0,0,0,0,"0217",4378,1397,2981
"8412",8412,0,0,0,0,"0218",11300,5807,5493
"8413",8413,426,179,992,625,"0219",4443,1860,2583
"8414",8414,650,537,1572,1209,"0220",1731,1456,275
"8415",8415,1145,360,3137,1525,"0221",1158,859,299
"8416",8416,230,489,1195,733,"0222",4428,1715,2713
"8417",8417,406,589,1873,1020,"0223",1974,402,1572
"8418",8418,296,464,1423,772,"0224",1121,138,983
"8419",8419,922,1953,3949,2914,"0225",6632,2781,3851
"8420",8420,574,1448,2679,2056,"0226",4761,1342,3419
"8421",8421,423,1477,2714,1944,"0227",3812,579,3233
"8422",8422,476,1984,3735,2492,"0228",2657,1615,1042
"8423",8423,281,78,779,365,"0229",2277,1346,931
"8424",8424,591,145,1539,742,"0231",2829,2259,570
"8425",8425,3,4,17,7,"0232",8030,5587,2443
"8426",8426,318,568,1425,901,"0233",4723,3372,1351
"8427",8427,351,270,788,630,"0234",2401,1800,601
"8428",8428,1139,397,2195,1567,"0235",3808,2603,1205
"8429",8429,740,2244,4038,3021,"0236",3374,2606,768
"8430",8430,559,162,1355,729,"0237",1986,1721,265
"8431",8431,493,182,1355,685,"0238",3457,2276,1181
"8432",8432,392,1068,1886,1476,"0239",2341,1951,390
"8433",8433,841,805,2377,1685,"0240",1055,869,186
"8434",8434,159,171,542,334,"0241",2240,1693,547
"8435",8435,140,79,262,220,"0242",7007,4842,2165
"8436",8436,739,1268,2455,2035,"0243",1955,1471,484
"8437",8437,212,65,543,282,"0244",5229,3580,1649
"8438",8438,578,1156,2831,1758,"0245",1645,1114,531
"8439",8439,381,72,941,456,"0246",2044,1542,502
"8440",8440,748,249,1964,1009,"0247",801,651,150
"8441",8441,594,255,1133,865,"0248",4072,1921,2151
"8442",8442,496,157,1134,663,"0249",2989,2226,763
"8443",8443,444,303,1327,754,"0250",6667,5125,1542
"8444",8444,332,331,1216,674,"0251",4022,2831,1191
"8445",8445,419,119,1031,546,"0252",3331,2250,1081
"8446",8446,433,134,993,574,"0253",3428,2795,633
"8447",8447,84,158,419,250,"0254",5612,2621,2991
"8448",8448,129,400,619,534,"0256",1910,1693,217
"8449",8449,855,846,2126,1724,"0258",3339,1808,1531
"8450",8450,547,379,1387,947,"0259",2997,2025,972
"8451",8451,685,943,2677,1667,"0260",5283,1338,3945
"8452",8452,598,194,1773,801,"0262",6511,3943,2568
"8453",8453,648,230,1922,894,"0263",3710,2374,1336
"8454",8454,507,396,1154,932,"0266",505,446,59
"8455",8455,172,174,682,354,"0267",2138,1326,812
"8456",8456,707,1247,3458,1996,"0268",1902,806,1096
"8457",8457,378,542,1109,939,"0273",3384,2731,653
"8458",8458,865,1176,2427,2074,"0274",3324,2201,1123
"8459",8459,430,470,1378,929,"0275",3996,2939,1057
"8460",8460,836,725,2678,1591,"0277",9941,4999,4942
"8461",8461,496,612,1415,1123,"0301",2177,1224,953
"8462",8462,241,289,1121,537,"0302",4199,2944,1255
"8463",8463,833,1019,3142,1885,"0303",3266,2351,915
"8464",8464,458,720,1746,1199,"0304",4104,2944,1160
"8465",8465,978,410,2673,1426,"0305",32,5,27
"8466",8466,432,646,1895,1097,"0306",3603,3048,555
"8467",8467,213,164,650,383,"0307",1305,1066,239
"8468",8468,515,485,1221,1019,"0308",8160,6755,1405
"8469",8469,1043,1204,3370,2286,"0309",3075,1995,1080
"8470",8470,521,349,1476,889,"0310",9302,4810,4492
"8471",8471,1128,1236,3088,2399,"0311",7655,4199,3456
"8472",8472,311,586,1411,916,"0312",2760,1949,811
"8473",8473,571,173,1389,752,"0313",544,301,243
"8474",8474,453,127,1084,590,"0314",8651,5661,2990
"8475",8475,536,512,1767,1064,"0315",4206,2770,1436
"8476",8476,808,512,2615,1346,"0316",6442,4438,2004
"8477",8477,980,1413,4114,2435,"0317",2934,2135,799
"8478",8478,368,456,1443,835,"0318",987,400,587
"8479",8479,339,357,1300,708,"0319",2624,2242,382
"8480",8480,1327,1428,3787,2802,"0320",2344,1980,364
"8481",8481,631,175,1558,813,"0321",702,566,136
"8482",8482,1128,1313,4091,2500,"0323",3205,1886,1319
"8483",8483,717,205,1747,944,"0324",8826,6145,2681
"8484",8484,1030,1432,3361,2513,"0325",188,141,47
"8485",8485,30,55,142,85,"0326",2528,1280,1248
"8486",8486,145,348,685,494,"0327",3126,2235,891
"8487",8487,546,669,1910,1240,"0328",5109,3311,1798
"8488",8488,70,20,208,91,"0329",7679,5331,2348
"8489",8489,0,0,0,0,"0330",2897,2187,710
"8490",8490,1308,1222,3880,2573,"0331",2758,1806,952
"8491",8491,374,387,1121,774,"0332",2855,2213,642
"8492",8492,320,212,745,548,"0333",4475,2369,2106
"8493",8493,295,99,847,398,"0334",3143,1954,1189
"8494",8494,223,651,1137,888,"0335",2933,1589,1344
"8495",8495,1038,1088,3469,2179,"0336",2197,1360,837
"8496",8496,166,277,679,452,"0337",4751,3385,1366
"8497",8497,718,892,2482,1648,"0338",5215,4039,1176
"8498",8498,42,162,293,206,"0339",2179,1456,723
"8499",8499,276,201,1030,485,"0340",4889,3628,1261
"8500",8500,92,21,261,114,"0341",604,458,146
"8501",8501,672,886,2585,1600,"0342",5184,3917,1267
"8502",8502,57,23,127,82,"0343",4527,2331,2196
"8503",8503,411,518,1666,948,"0344",2023,1350,673
"8504",8504,888,1080,2930,1998,"0345",8,0,8
"8505",8505,443,1216,2446,1684,"0346",6067,4924,1143
"8506",8506,779,1001,2309,1834,"0347",2760,2162,598
"8507",8507,763,1112,2292,1897,"0349",6858,4496,2362
"8508",8508,474,702,1467,1194,"0350",5684,3254,2430
"8509",8509,667,413,1485,1108,"0351",3378,1541,1837
"8510",8510,0,3,7,3,"0352",4413,2715,1698
"8511",8511,981,1734,3833,2781,"0354",4787,3811,976
"8512",8512,0,0,0,0,"0356",2679,1827,852
"8513",8513,440,1660,2644,2120,"0357",558,463,95
"8514",8514,44,113,269,162,"0358",5600,3462,2138
"8515",8515,734,845,2339,1613,"0359",7512,5080,2432
"8516",8516,677,1447,2943,2154,"0360",4990,3118,1872
"8517",8517,72,359,674,434,"0361",1713,1280,433
"8518",8518,120,158,450,283,"0362",3019,2144,875
"8519",8519,33,85,160,124,"0363",1555,1182,373
"8520",8520,88,117,393,213,"0364",3463,2875,588
"8521",8521,983,992,3108,2003,"0365",3821,2524,1297
"8522",8522,754,975,2413,1766,"0366",5346,3599,1747
"8523",8523,17,7,133,28,"0367",7176,4669,2507
"8524",8524,1226,1141,3349,2402,"0368",376,316,60
"8525",8525,721,1258,3059,2015,"0369",7517,4695,2822
"8526",8526,347,516,1095,887,"0370",2503,1715,788
"8527",8527,3,4,19,7,"0371",4074,3049,1025
"8528",8528,35,10,58,45,"0372",2623,2018,605
"8529",8529,0,0,0,0,"0373",6993,5728,1265
"8530",8530,249,524,950,787,"0374",7249,5053,2196
"8531",8531,21,12,54,34,"0375",1134,894,240
"8532",8532,130,136,475,272,"0401",5424,1115,4309
"8533",8533,0,0,0,0,"0402",8245,1121,7124
"8534",8534,425,287,1147,729,"0403",3001,737,2264
"8535",8535,825,798,2159,1648,"0404",7780,2639,5141
"8536",8536,0,3,7,3,"0405",2160,939,1221
"8537",8537,61,35,160,97,"0406",5023,2316,2707
"8538",8538,281,131,790,422,"0407",9254,2515,6739
"8539",8539,1060,552,3665,1639,"0408",4559,2177,2382
"8540",8540,181,301,559,490,"0409",2572,1626,946
"8541",8541,1460,1383,4633,2891,"0410",5212,2173,3039
"8542",8542,362,191,1014,560,"0411",3796,1638,2158
"8543",8543,1316,1558,4421,2929,"0412",380,111,269
"8544",8544,0,0,0,0,"0413",4189,1568,2621
"8545",8545,1226,1492,3940,2775,"0414",6123,2778,3345
"8546",8546,724,1340,3082,2104,"0415",1494,842,652
"8547",8547,216,726,1240,953,"0416",1469,624,845
"8548",8548,420,582,1567,1016,"0417",3461,1411,2050
"8549",8549,1159,1649,4275,2869,"0418",25,3,22
"8550",8550,1010,1148,3387,2197,"0419",759,422,337
"8551",8551,1199,1586,4126,2836,"0420",4427,2266,2161
"8552",8552,0,0,0,0,"0421",3048,2409,639
"8553",8553,11,14,40,25,"0422",2724,1925,799
"8554",8554,11,28,72,40,"0423",8088,1514,6574
"8555",8555,17,7,44,25,"0424",3283,1889,1394
"8556",8556,0,0,0,0,"0425",803,435,368
"8557",8557,117,6,242,129,"0426",4022,1738,2284
"8558",8558,1309,1741,4280,3101,"0427",3414,1232,2182
"8559",8559,1040,1134,3190,2221,"0428",2451,1802,649
"8560",8560,0,0,0,0,"0429",12537,5237,7300
"8561",8561,179,142,664,329,"0430",2446,1252,1194
"8562",8562,17,29,94,47,"0431",12531,4677,7854
"8563",8563,51,23,144,74,"0432",19,6,13
"8564",8564,832,974,2452,1842,"0433",4306,2212,2094
"8565",8565,0,0,0,0,"0434",0,0,0
"8566",8566,0,0,3,0,"0435",7710,4178,3532
"8567",8567,0,0,0,0,"0436",598,184,414
"8568",8568,19,10,98,29,"0437",2622,1898,724
"8569",8569,0,0,0,0,"0438",2426,1348,1078
"8570",8570,0,0,0,0,"0439",5114,2631,2483
"8571",8571,0,0,0,0,"0440",1955,975,980
"8572",8572,503,359,1264,882,"0441",6897,3410,3487
"8573",8573,1040,1226,3139,2312,"0442",2473,1273,1200
"8574",8574,276,176,741,464,"0443",7335,1013,6322
"8575",8575,800,1493,3386,2333,"0444",674,74,600
"8576",8576,986,1257,3223,2284,"0446",1235,657,578
"8577",8577,0,0,0,0,"0447",5501,2520,2981
"8578",8578,129,82,384,217,"0448",7532,1359,6173
"8579",8579,0,0,0,0,"0450",7586,1950,5636
"8580",8580,0,1,6,1,"0451",5290,2217,3073
"8581",8581,0,0,0,0,"0452",6127,747,5380
"8582",8582,65,40,224,106,"0454",3022,1924,1098
"8583",8583,64,52,170,116,"0458",4550,2848,1702
"8584",8584,670,935,2189,1638,"0460",3975,2522,1453
"8585",8585,520,697,1747,1240,"0461",6364,4391,1973
"8586",8586,1034,943,3110,2028,"0463",4988,2313,2675
"8587",8587,848,851,2564,1732,"0001",717,605,112
"8588",8588,576,449,1820,1050,"0002",1029,909,120
"8589",8589,720,868,2344,1605,"0003",569,527,42
"8590",8590,1004,1182,3212,2227,"0004",280,249,31
"8591",8591,137,600,1024,745,"0005",575,330,245
"8592",8592,853,1193,2792,2088,"0006",231,206,25
"8593",8593,742,879,2204,1651,"0007",192,169,23
"8594",8594,282,942,1742,1256,"0008",455,416,39
"8595",8595,435,529,1429,981,"0009",574,511,63
"8596",8596,8,10,27,18,"0010",323,308,15
"8597",8597,0,0,0,0,"0011",1935,1668,267
"8598",8598,804,1629,3763,2494,"0012",128,111,17
"8599",8599,495,1085,2586,1645,"0014",714,629,85
"8600",8600,508,1163,2803,1709,"0015",125,115,10
"8601",8601,473,1426,2438,1941,"0016",612,433,179
"8602",8602,751,1361,4018,2180,"0017",522,134,388
"8603",8603,317,440,1753,791,"0018",117,34,83
"8604",8604,72,354,729,435,"0019",1290,972,318
"8605",8605,113,872,1298,995,"0020",75,51,24
"8606",8606,21,176,248,198,"0021",519,439,80
"8607",8607,6,68,84,75,"0001",665,576,89
"8608",8608,343,524,2021,893,"0002",1167,653,514
"8609",8609,689,842,3382,1563,"0003",1571,1219,352
"8610",8610,848,1277,4070,2178,"0004",1355,1207,148
"8611",8611,388,1022,2117,1442,"0005",214,164,50
"8612",8612,726,1068,3606,1836,"0006",400,380,20
"8613",8613,262,1510,2576,1794,"0007",560,506,54
"8614",8614,31,200,331,233,"0008",190,172,18
"8615",8615,509,1183,2666,1739,"0009",446,396,50
"8616",8616,424,1262,2447,1736,"0010",1221,1090,131
"8617",8617,132,1480,2039,1629,"0011",131,108,23
"8618",8618,649,1544,3464,2264,"0013",872,794,78
"8619",8619,593,2160,3688,2811,"0014",1635,1465,170
"8620",8620,654,2638,4423,3356,"0015",1009,933,76
"8621",8621,525,2196,3696,2786,"0016",689,638,51
"8622",8622,190,1231,1792,1442,"0017",2375,905,1470
"8623",8623,368,1501,2453,1899,"0018",1475,1224,251
"8624",8624,890,1442,3201,2398,"0001",1853,1491,362
"8625",8625,605,931,2489,1585,"0002",3224,2789,435
"8626",8626,528,841,2356,1406,"0003",1835,1428,407
"8627",8627,354,744,1918,1119,"0004",1284,999,285
"8628",8628,662,1592,3158,2301,"0005",906,661,245
"8629",8629,214,685,1361,916,"0006",1520,1247,273
"8630",8630,386,2462,3633,2899,"0007",2856,2187,669
"8631",8631,58,638,925,709,"0008",1237,953,284
"8632",8632,38,84,172,122,"0009",2228,1793,435
"8633",8633,44,50,161,97,"0010",2520,2196,324
"8634",8634,7,11,33,18,"0011",676,581,95
"8635",8635,18,106,182,126,"0012",1040,886,154
"8636",8636,7,48,68,56,"0013",1012,721,291
"8637",8637,3,19,29,22,"0014",591,434,157
"8638",8638,2,16,27,19,"0015",2107,1776,331
"8639",8639,175,936,1663,1124,"0016",2089,1497,592
"8640",8640,124,416,1063,549,"0017",2741,1936,805
"8641",8641,72,266,545,340,"0018",974,694,280
"8642",8642,225,502,1673,735,"0019A",26,14,12
"8643",8643,155,550,1400,712,"0019B",0,0,0
"8644",8644,6,142,226,152,"0020",126,105,21
"8645",8645,12,223,314,237,"0021",9,2,7
"8646",8646,21,196,302,217,"0001",433,298,135
"8647",8647,27,204,315,234,"0002",257,130,127
"8648",8648,13,45,75,58,"0003",650,201,449
"8649",8649,9,138,200,148,"0004",553,232,321
"8650",8650,238,80,744,323,"0005",117,47,70
"8651",8651,139,273,650,413,"0006",428,154,274
"8652",8652,90,367,667,461,"0001",2411,712,1699
"8653",8653,92,430,709,525,"0002",1361,544,817
"8654",8654,21,203,314,227,"0003",463,398,65
"8655",8655,126,730,1355,862,"0004",366,263,103
"8656",8656,137,658,1252,801,"0005",2271,978,1293
"8657",8657,306,280,1459,598,"0006",186,142,44
"8658",8658,66,218,494,289,"0007",592,311,281
"8659",8659,69,593,920,665,"0008",2006,449,1557
"8660",8660,23,103,293,127,"0009",1599,127,1472
"8661",8661,29,171,322,201,"0010",747,40,707
"8662",8662,390,621,1847,1024,"0011",581,251,330
"8663",8663,86,451,846,543,"0012",2469,850,1619
"8664",8664,388,1237,2547,1642,"0013",3352,448,2904
"8665",8665,180,116,652,302,"0014",76,51,25
"8666",8666,31,112,242,146,"0010A",70,7,63
"8667",8667,156,305,833,471,"0010B",2868,267,2601
"8668",8668,289,622,1449,921,"0011",2530,102,2428
"8669",8669,313,469,1598,789,"0012",551,78,473
"8670",8670,209,442,1138,656,"0013",1835,1082,753
"8671",8671,67,554,848,625,"0020",138,97,41
"8672",8672,74,646,1008,726,"0021",2515,69,2446
"8673",8673,238,149,960,399,"0022",3928,1084,2844
"8674",8674,390,291,1641,689,"0023",212,85,127
"8675",8675,608,826,2685,1461,"0024",2164,197,1967
"8676",8676,401,514,1721,925,"0030",2049,322,1727
"8677",8677,659,874,3459,1557,"0031",5285,1518,3767
"8678",8678,565,1424,3131,2027,"0032",244,140,104
"8679",8679,201,2014,2729,2227,"0033",2508,942,1566
"8680",8680,424,1355,2484,1797,"0040",5989,487,5502
"8681",8681,5,63,98,68,"0041A",218,40,178
"8682",8682,495,1214,2705,1747,"0041B",1776,112,1664
"8683",8683,500,1219,2713,1761,"0042",30,19,11
"8684",8684,888,2932,5093,3866,"0043",61,46,15
"8685",8685,557,1490,3403,2068,"001A",2205,1889,316
"8686",8686,324,765,1800,1109,"001B",3974,3205,769
"8687",8687,74,121,375,199,"001C",1924,1639,285
"8688",8688,251,1506,2629,1777,"001D",1672,1388,284
"8689",8689,686,1794,3512,2514,"001E",1048,819,229
"8690",8690,456,746,2144,1231,"002A",4405,3822,583
"8691",8691,169,773,1471,955,"002B",1815,1601,214
"8692",8692,63,226,373,295,"002C",2975,2608,367
"8693",8693,167,1021,1782,1199,"002D",2531,2194,337
"8694",8694,30,74,154,106,"003A",1457,1184,273
"8695",8695,678,1224,3083,1935,"003B",2445,1769,676
"8696",8696,119,336,634,461,"003C",4767,3809,958
"8697",8697,631,1882,3565,2549,"003D",3369,2970,399
"8698",8698,118,925,1347,1051,"004A",1458,1243,215
"8699",8699,91,720,1040,818,"004B",2182,1786,396
"8700",8700,453,1069,2305,1543,"004C",2118,1761,357
"8701",8701,258,434,1263,708,"004D",4192,3388,804
"8702",8702,222,433,1289,667,"004E",1433,1156,277
"8703",8703,801,1733,3739,2591,"0001",793,153,640
"8704",8704,1898,194,3471,2148,"0002",1352,561,791
"8705",8705,1746,198,3214,2000,"0003",1469,718,751
"8706",8706,1954,154,3192,2154,"0004",2365,351,2014
"8707",8707,1690,118,2724,1860,"0005",3880,1013,2867
"8708",8708,2438,134,3582,2610,"0006",711,90,621
"8709",8709,1795,157,3010,2006,"0007",2706,399,2307
"8710",8710,2126,254,3076,2434,"0008",3224,918,2306
"8711",8711,2435,292,3509,2798,"0009",1757,717,1040
"8712",8712,1522,127,2706,1688,"0010",2095,1079,1016
"8713",8713,1571,122,2795,1745,"0011",412,264,148
"8714",8714,1287,125,2187,1437,"0012",812,292,520
"8715",8715,1644,192,2668,1879,"0013",1676,376,1300
"8716",8716,1685,202,2424,1931,"0014",1641,909,732
"8717",8717,383,38,717,437,"0015",140,82,58
"8718",8718,1861,209,3343,2108,"0016",525,360,165
"8719",8719,1760,188,2824,1997,"0017",1063,389,674
"8720",8720,1132,105,2081,1267,"0018",4587,2889,1698
"8721",8721,1033,136,1983,1188,"0019",3678,1460,2218
"8722",8722,1096,156,2213,1277,"0020",1475,1028,447
"8723",8723,903,183,1692,1118,"0021",4363,2803,1560
"8724",8724,1105,155,2233,1288,"0022",1635,1357,278
"8725",8725,466,91,860,571,"0023",1744,1198,546
"8726",8726,1712,434,3173,2206,"0024",1488,1115,373
"8727",8727,1814,555,3451,2441,"0025",5360,2810,2550
"8728",8728,2555,360,4740,2994,"0026",1230,745,485
"8729",8729,1172,257,2730,1474,"0027",1733,1402,331
"8730",8730,1838,436,4593,2335,"0028",586,403,183
"8731",8731,1191,244,2447,1475,"0029",2669,1678,991
"8732",8732,1355,375,2503,1774,"0030",631,261,370
"8733",8733,686,282,1415,990,"0031",1337,521,816
"8734",8734,861,286,1735,1184,"0032",2138,446,1692
"8735",8735,1679,404,3195,2142,"0033",5006,3298,1708
"8736",8736,2717,875,5056,3690,"0034",1649,176,1473
"8737",8737,223,66,389,295,"0035",873,103,770
"8738",8738,2541,761,4473,3391,"0101",2235,797,1438
"8739",8739,1352,425,2575,1823,"0102",8400,4295,4105
"8740",8740,1916,608,3658,2589,"0103",2016,1264,752
"8741",8741,990,313,1890,1339,"0104",2247,1668,579
"8742",8742,529,407,1519,964,"0201",9319,4045,5274
"8743",8743,153,185,464,344,"0203",709,593,116
"8744",8744,1844,925,3630,2841,"0204",2891,1838,1053
"8745",8745,22,10,42,32,"0205",3392,3013,379
"8746",8746,1263,636,2479,1947,"0206",1540,865,675
"8747",8747,0,0,0,0,"0301",7099,2468,4631
"8748",8748,1486,903,3131,2448,"0302",893,533,360
"8749",8749,1731,1044,3646,2850,"0303",864,427,437
"8750",8750,1538,944,3247,2539,"0304",9684,5013,4671
"8751",8751,20,11,41,31,"0401",7719,3595,4124
"8752",8752,1625,994,3431,2683,"0403",1962,1250,712
"8753",8753,1253,764,2700,2078,"0404",3873,2974,899
"8754",8754,1137,560,2762,1736,"0101",2337,1161,1176
"8755",8755,881,388,1850,1311,"0102",2149,727,1422
"8756",8756,1907,830,3985,2820,"0103",1510,553,957
"8757",8757,1492,646,3111,2205,"0104",1020,462,558
"8758",8758,1410,675,3125,2149,"0105",981,680,301
"8759",8759,1412,561,2940,2020,"0206",3313,2249,1064
"8760",8760,1615,685,3688,2362,"0207",4218,3208,1010
"8761",8761,1575,750,3661,2385,"0208",2098,1032,1066
"8762",8762,186,114,423,310,"0309",5955,37,5918
"8763",8763,693,572,1728,1300,"0310",1893,291,1602
"8764",8764,501,286,1073,812,"0311",1078,506,572
"8765",8765,3,1,9,5,"0312",1880,1185,695
"8766",8766,15,6,37,23,"0313",1478,440,1038
"8767",8767,1645,937,3659,2663,"0414",644,148,496
"8768",8768,882,565,2042,1494,"0415",1805,884,921
"8769",8769,1283,610,3051,1946,"0416",2791,754,2037
"8770",8770,1395,504,2993,1943,"0417",1571,320,1251
"8771",8771,1065,387,2295,1493,"0418",3305,1959,1346
"8772",8772,553,196,1177,768,"0419",913,576,337
"8773",8773,1241,446,2663,1724,"0420A",2220,1531,689
"8774",8774,366,131,785,505,"0420B",40,17,23
"8775",8775,1345,424,2840,1827,"0002",2137,1072,1065
"8776",8776,1186,322,2823,1546,"001E",1931,513,1418
"8777",8777,1463,456,2851,1970,"001W",257,46,211
"8778",8778,1357,505,2838,1908,"003N",1824,886,938
"8779",8779,1442,478,2950,1968,"003S",353,164,189
"8780",8780,1292,424,2655,1766,"004E",1612,652,960
"8781",8781,2457,604,4143,3164,"004M",298,173,125
"8782",8782,2164,776,3647,3020,"004W",74,49,25
"8783",8783,2033,246,3509,2337,"0101",1344,734,610
"8784",8784,2115,258,3792,2434,"0104",2538,624,1914
"8785",8785,2031,302,3759,2410,"0109",1143,876,267
"8786",8786,2342,404,3429,2800,"0115",1183,694,489
"8787",8787,1799,188,2979,2027,"0117",174,42,132
"8788",8788,2242,276,3769,2583,"0121",108,65,43
"8789",8789,1245,291,1929,1586,"0202",381,243,138
"8790",8790,1884,275,2774,2212,"0203",1935,1440,495
"8791",8791,2486,288,3911,2838,"0205",3012,2322,690
"8792",8792,2053,247,3407,2357,"0208",1997,1309,688
"8793",8793,1449,160,2323,1651,"0307",2199,1291,908
"8794",8794,508,50,940,573,"0311",1308,1055,253
"8795",8795,1844,260,3421,2156,"0312",1298,968,330
"8796",8796,1825,345,2626,2223,"0316",418,304,114
"8797",8797,2768,423,4109,3259,"0320",2171,1794,377
"8798",8798,1326,287,2103,1670,"0406",2827,1536,1291
"8799",8799,1555,216,2304,1808,"0410",1216,951,265
"8800",8800,2021,276,2997,2356,"0413",860,729,131
"8801",8801,1847,407,3044,2313,"0414",826,681,145
"8802",8802,1770,334,2969,2153,"0418",686,438,248
"8803",8803,2440,805,4278,3345,"0419",637,423,214
"8804",8804,2213,1153,4101,3467,"0122",775,27,748
"8805",8805,2131,815,3496,3023,"0124",2852,46,2806
"8806",8806,2131,872,3616,3083,"0125",1190,10,1180
"8807",8807,1934,495,3196,2488,"0128",810,0,810
"8808",8808,1857,852,3334,2786,"0129",3114,53,3061
"8809",8809,2505,894,4634,3496,"0130",5636,78,5558
"8810",8810,1981,631,3372,2675,"0132",9493,920,8573
"8811",8811,2023,634,3571,2739,"0133",4480,50,4430
"8812",8812,1839,466,3873,2375,"0134",2937,54,2883
"8813",8813,1566,374,3384,1990,"0135",1758,25,1733
"8814",8814,1720,469,3698,2244,"0136",200,10,190
"8815",8815,1841,592,3523,2507,"0154",6642,135,6507
"8816",8816,1414,402,2788,1872,"0164",1726,47,1679
"8817",8817,2063,585,4050,2720,"0169",3231,85,3146
"8818",8818,1905,534,3717,2504,"0215",2417,65,2352
"8819",8819,1262,314,2457,1614,"0218",3059,83,2976
"8820",8820,1192,349,2350,1579,"0219",2329,96,2233
"8821",8821,1599,514,3279,2156,"0220",1973,69,1904
"8822",8822,554,302,1568,865,"0221",1229,76,1153
"8823",8823,1051,446,2191,1535,"0226",1507,47,1460
"8824",8824,2306,767,4453,3149,"0227",7909,212,7697
"8825",8825,1946,643,3755,2666,"0231",4731,149,4582
"8826",8826,1724,572,3373,2356,"0237",416,28,388
"8827",8827,1211,472,2345,1730,"0239",8335,381,7954
"8828",8828,1132,416,2225,1585,"0252",4919,102,4817
"8829",8829,1657,594,3273,2301,"0255",2952,178,2774
"8830",8830,1747,598,3494,2405,"0266",3287,115,3172
"8831",8831,1981,620,3412,2687,"0267",3458,99,3359
"8832",8832,1329,398,2403,1781,"0268",642,13,629
"8833",8833,1861,564,3522,2498,"0308",1275,58,1217
"8834",8834,1792,830,3167,2669,"0309",3630,145,3485
"8835",8835,1473,623,2516,2135,"0310",488,12,476
"8836",8836,2060,1318,4684,3472,"0311",2271,74,2197
"8837",8837,1128,985,2624,2163,"0312",1732,29,1703
"8838",8838,1905,1904,4881,3904,"0338",394,21,373
"8839",8839,1263,1259,3228,2579,"0340",2490,207,2283
"8840",8840,1754,1294,4248,3115,"0341",1795,120,1675
"8841",8841,925,669,2323,1624,"0342",3081,175,2906
"8842",8842,949,1843,3617,2866,"0343",2753,155,2598
"8843",8843,874,1686,3295,2609,"0344",6507,423,6084
"8844",8844,662,1028,2228,1737,"0345",2199,106,2093
"8845",8845,2051,1766,4816,3918,"0349",4125,260,3865
"8846",8846,480,361,1179,867,"0350",33,8,25
"8847",8847,1309,1344,3565,2715,"0351",1290,204,1086
"8848",8848,1586,1565,4257,3224,"0356",6046,326,5720
"8849",8849,901,944,2586,1877,"0359",5319,251,5068
"8850",8850,1205,332,2669,1579,"0360",917,33,884
"8851",8851,1307,535,3125,1896,"0361",2556,78,2478
"8852",8852,2091,729,4443,2914,"0362",714,26,688
"8853",8853,256,100,521,370,"0363",1337,32,1305
"8854",8854,2614,592,4693,3309,"0401",2457,156,2301
"8855",8855,1320,313,2572,1679,"0402",2301,53,2248
"8856",8856,2844,430,4249,3340,"0403",1640,31,1609
"8857",8857,2524,433,3995,3034,"0404",2554,38,2516
"8858",8858,1844,328,3779,2219,"0405",2578,22,2556
"8859",8859,2092,394,4292,2538,"0406",1429,32,1397
"8860",8860,1587,265,3964,1914,"0407",923,19,904
"8861",8861,1596,293,3263,1922,"0413",3115,61,3054
"8862",8862,1603,265,3250,1914,"0414",1921,34,1887
"8863",8863,1625,287,3723,1963,"0416",1636,42,1594
"8864",8864,1994,1113,4042,3205,"0417",1034,34,1000
"8865",8865,1015,589,1999,1653,"0423",1514,26,1488
"8866",8866,1743,936,3296,2756,"0446",4919,135,4784
"8867",8867,1333,838,2768,2234,"0447",5157,277,4880
"8868",8868,1456,909,3008,2420,"0448",606,26,580
"8869",8869,514,265,994,798,"0453",827,14,813
"8870",8870,1520,1136,3330,2738,"0457",70,13,57
"8871",8871,1445,822,2801,2321,"0458",5581,168,5413
"8872",8872,2513,663,4347,3276,"0465",1233,17,1216
"8873",8873,1220,285,2069,1550,"0101A",1313,591,722
"8874",8874,1536,377,2670,1967,"0101B",1818,709,1109
"8875",8875,1433,419,2536,1901,"0102",2797,1655,1142
"8876",8876,1781,690,3241,2537,"0103",2537,1256,1281
"8877",8877,1888,937,3543,2891,"0201",2674,2021,653
"8878",8878,1574,711,3080,2345,"0202",932,288,644
"8879",8879,2334,1066,4577,3484,"0203",3890,1124,2766
"8880",8880,2071,797,3597,2940,"0301",2864,1951,913
"8881",8881,1577,470,2803,2093,"0302",3067,1529,1538
"8882",8882,2067,614,3691,2754,"0303",2268,1580,688
"8883",8883,1452,675,2591,2181,"0401",3928,1104,2824
"8884",8884,27,13,48,41,"0402",2214,818,1396
"8885",8885,1734,713,3042,2506,"0403",1012,386,626
"8886",8886,1818,643,3292,2530,"0001",182,169,13
"8887",8887,2223,1001,4004,3317,"0002",653,439,214
"8888",8888,1815,803,3334,2697,"0003",755,505,250
"8889",8889,1489,702,2682,2253,"0004",179,160,19
"8890",8890,214,112,404,333,"0005",94,81,13
"8891",8891,1922,992,3643,2994,"0006",120,116,4
"8892",8892,2351,785,4343,3233,"0007",146,134,12
"8893",8893,1727,1383,3995,3182,"0008",666,468,198
"8894",8894,1392,882,3208,2323,"0009",877,677,200
"8895",8895,1441,1160,3327,2661,"0010",101,85,16
"8896",8896,2086,1038,4045,3231,"0101",294,263,31
"8897",8897,545,268,1054,841,"0102",963,762,201
"8898",8898,1458,586,2714,2092,"0103",5986,4197,1789
"8899",8899,1880,752,3503,2700,"0104",1738,1207,531
"8900",8900,2014,779,3478,2878,"0105",4126,2805,1321
"8901",8901,1621,1055,3329,2732,"0106",1018,853,165
"8902",8902,680,486,1622,1196,"0107",26,25,1
"8903",8903,1152,1230,2953,2437,"0108",4463,3099,1364
"8904",8904,1220,1298,3128,2583,"0109",4234,3252,982
"8905",8905,867,1327,2727,2240,"0110",769,586,183
"8906",8906,663,1091,2232,1794,"0111",1817,794,1023
"8907",8907,1072,1784,3626,2905,"0112",73,37,36
"8908",8908,766,1273,2611,2088,"0113",1242,756,486
"8909",8909,1566,1481,4076,3106,"0114",14,11,3
"8910",8910,991,938,2594,1972,"0115",8,7,1
"8911",8911,222,219,594,451,"0116",66,56,10
"8912",8912,22,23,60,46,"0117",78,68,10
"8913",8913,803,1000,2290,1832,"0201",6280,3809,2471
"8914",8914,937,1206,2809,2200,"0202",2541,1554,987
"8915",8915,1342,1802,3962,3210,"0203",3431,2169,1262
"8916",8916,1158,1774,3630,2981,"0204",809,677,132
"8917",8917,2389,1054,4432,3539,"0205",4706,3834,872
"8918",8918,1365,640,3727,2077,"0206",3914,3197,717
"8919",8919,0,0,0,0,"0207",1099,607,492
"8920",8920,60,26,110,88,"0208",185,111,74
"8921",8921,30,13,55,44,"0209",0,0,0
"8922",8922,1986,696,3854,2762,"0210",1,0,1
"8923",8923,2093,841,3778,3003,"0211",256,181,75
"8924",8924,2234,1017,4245,3349,"0301",261,209,52
"8925",8925,1697,976,3346,2752,"0302",3402,1616,1786
"8926",8926,20,9,37,30,"0303",3035,1013,2022
"8927",8927,1191,555,2216,1788,"0304",470,211,259
"8928",8928,0,0,1,1,"0305",729,416,313
"8929",8929,16,8,30,24,"0306",1369,360,1009
"8930",8930,1233,628,2598,1913,"0307",4258,1493,2765
"8931",8931,1773,1527,4313,3387,"0308",1490,679,811
"8932",8932,1194,1042,2914,2291,"0309",4466,3927,539
"8933",8933,760,923,2283,1723,"0310",1976,1716,260
"8934",8934,1415,1476,3540,2952,"0311",3770,1167,2603
"8935",8935,1197,1254,2988,2501,"0312",187,63,124
"8936",8936,795,1179,2794,2023,"0313",84,37,47
"8937",8937,677,1129,2651,1853,"0315",202,148,54
"8938",8938,1043,421,2162,1517,"0316",147,69,78
"8939",8939,2341,284,4036,2687,"0317",97,86,11
"8940",8940,2234,232,3850,2515,"0318",545,375,170
"8941",8941,1822,211,3373,2087,"0319",82,48,34
"8942",8942,168,19,452,190,"0401",2894,2165,729
"8943",8943,2168,238,3811,2473,"0402",970,704,266
"8944",8944,1745,226,2830,2028,"0403",3072,2168,904
"8945",8945,1971,357,3337,2378,"0404",2926,2196,730
"8946",8946,1469,248,2640,1761,"0405",2901,1720,1181
"8947",8947,1630,217,2641,1882,"0406",3806,2804,1002
"8948",8948,3030,528,5064,3650,"0407",3046,1691,1355
"8949",8949,1738,237,3025,2026,"0408",36,20,16
"8950",8950,1891,289,3193,2242,"0409",2,0,2
"8951",8951,993,150,1867,1166,"0410",322,248,74
"8952",8952,1961,300,3694,2309,"0411",1211,807,404
"8953",8953,2836,403,5581,3325,"0412",711,636,75
"8954",8954,1624,262,3391,1938,"0413",1291,1025,266
"8955",8955,2029,326,4238,2424,"0414",797,660,137
"8956",8956,1375,221,2957,1641,"0001A",2414,1508,906
"8957",8957,1764,307,3807,2129,"0001B",143,128,15
"8958",8958,1931,356,3683,2355,"0019",2341,1306,1035
"8959",8959,1138,139,2334,1316,"0020",1945,968,977
"8960",8960,1748,229,3588,2040,"0021",3078,1983,1095
"8961",8961,1430,393,2686,1870,"0001",2073,94,1979
"8962",8962,1819,374,3115,2239,"0002A",118,25,93
"8963",8963,739,105,1226,864,"0002B",1544,113,1431
"8964",8964,433,114,784,565,"0003",1043,103,940
"8965",8965,1280,243,2367,1563,"0004",1866,147,1719
"8966",8966,1135,216,2101,1391,"0005",925,63,862
"8967",8967,1471,341,2535,1848,"0006",494,48,446
"8968",8968,2620,505,4856,3212,"0007",1385,139,1246
"8969",8969,1315,248,2504,1606,"0008",1042,72,970
"8970",8970,1371,254,2585,1674,"0009",1123,60,1063
"8971",8971,1570,456,2792,2075,"0010",299,223,76
"8972",8972,2061,536,3629,2663,"0011",3449,475,2974
"8973",8973,732,219,1439,972,"0012",123,12,111
"8974",8974,1697,342,3238,2079,"0119",4286,2472,1814
"8975",8975,2135,632,3896,2839,"0122",3356,2098,1258
"8976",8976,2686,661,4629,3435,"0135",5695,2182,3513
"8977",8977,1014,270,1852,1317,"0138",5414,3224,2190
"8978",8978,1620,509,2972,2177,"0140",2045,1382,663
"8979",8979,1403,418,2573,1873,"0145",4864,1682,3182
"8980",8980,1530,478,2954,2064,"0146",6213,3552,2661
"8981",8981,968,306,1878,1310,"0147",6266,3230,3036
"8982",8982,1432,427,2770,1901,"0149",4665,2309,2356
"8983",8983,979,189,2507,1198,"0150",4374,1889,2485
"8984",8984,1361,294,2887,1700,"0151",3453,2144,1309
"8985",8985,2089,406,4837,2553,"0152",3772,2118,1654
"8986",8986,732,169,1362,927,"0160",5800,3235,2565
"8987",8987,1518,358,2763,1917,"0162",4008,2422,1586
"8988",8988,1397,287,2781,1723,"0172",2678,1370,1308
"8989",8989,1548,292,3554,1889,"0182",4248,2723,1525
"8990",8990,1462,332,2760,1846,"0185",1672,1041,631
"8991",8991,1442,379,2661,1874,"0186",4018,1315,2703
"8992",8992,2129,544,3686,2750,"0189",3962,2018,1944
"8993",8993,1669,984,3813,2731,"0190",5020,3351,1669
"8994",8994,1142,291,1971,1479,"0197",3170,1479,1691
"8995",8995,535,204,1104,757,"0198",5309,2688,2621
"8996",8996,432,272,1270,727,"0201",9240,4181,5059
"8997",8997,528,91,1142,637,"0202",2678,1484,1194
"8998",8998,1404,586,3343,2026,"0204",6300,3873,2427
"8999",8999,986,241,2163,1261,"0206",4750,3590,1160
"9000",9000,1747,593,4213,2398,"0207",6583,5060,1523
"9001",9001,1172,904,3331,2130,"0216",2568,1829,739
"9002",9002,2232,507,4173,2813,"0218",3606,2327,1279
"9003",9003,0,0,0,0,"0253",5573,3534,2039
"9004",9004,67,314,637,382,"0254",4656,2938,1718
"9005",9005,84,459,887,546,"0259",7069,4455,2614
"9006",9006,54,261,513,317,"0263",7071,4194,2877
"9007",9007,42,200,329,244,"0264",7613,4667,2946
"9008",9008,44,170,377,214,"0266",6961,4107,2854
"9009",9009,26,135,214,161,"0267",8769,5911,2858
"9010",9010,22,162,227,185,"0273",3283,2313,970
"9011",9011,40,218,436,259,"0274",11013,5471,5542
"9012",9012,68,336,657,406,"0275",4243,2192,2051
"9013",9013,37,179,351,216,"0277",5434,3861,1573
"9014",9014,219,960,2099,1194,"0278",5623,3780,1843
"9015",9015,17,66,122,83,"0283",6734,3828,2906
"9016",9016,79,338,752,419,"0287",5424,3692,1732
"9017",9017,13,76,138,89,"0305",3744,3079,665
"9018",9018,79,313,639,393,"0309",1795,1421,374
"9019",9019,170,350,873,521,"0310",2571,1584,987
"9020",9020,40,49,126,89,"0311",3016,1714,1302
"9021",9021,178,743,1626,926,"0312",8522,4613,3909
"9022",9022,5,43,70,48,"0314",5264,3259,2005
"9023",9023,39,207,431,247,"0330",4425,3021,1404
"9024",9024,41,283,430,330,"0331",5318,3185,2133
"9025",9025,249,544,1372,803,"0332",5234,3122,2112
"9026",9026,217,765,1593,990,"0333A",4632,2861,1771
"9027",9027,97,865,1386,971,"0333B",25,20,5
"9028",9028,54,94,277,151,"0337",5819,3133,2686
"9029",9029,48,287,432,337,"0339",4776,2249,2527
"9030",9030,38,432,618,475,"0341",2312,1659,653
"9031",9031,20,139,207,162,"0342",1914,896,1018
"9032",9032,23,298,457,323,"0343",5749,4042,1707
"9033",9033,114,872,1393,1000,"0344",6115,4829,1286
"9034",9034,3,78,139,82,"0345",3799,2896,903
"9035",9035,63,399,821,465,"0368",6897,3411,3486
"9036",9036,93,1040,1707,1150,"0369",7424,4157,3267
"9037",9037,62,660,1061,728,"0370",7973,4765,3208
"9038",9038,49,410,678,470,"0371",3144,2265,879
"9039",9039,113,347,688,462,"0379",4814,3857,957
"9040",9040,119,681,1270,808,"0381",3185,3048,137
"9041",9041,219,1314,1764,1555,"0392",6106,5014,1092
"9042",9042,115,1532,2906,1669,"0393",2260,2126,134
"9043",9043,120,895,1540,1029,"0394",3758,3554,204
"9044",9044,138,717,1284,873,"0395",3722,2962,760
"9045",9045,69,280,543,354,"0396",4490,4150,340
"9046",9046,166,941,1567,1121,"0402",8802,3969,4833
"9047",9047,301,1595,2999,1929,"0403",4078,2019,2059
"9048",9048,104,500,951,616,"0413",725,497,228
"9049",9049,222,1112,2132,1360,"0415",2253,1558,695
"9050",9050,180,1575,2640,1787,"0420",11526,5639,5887
"9051",9051,97,390,749,498,"0423",5616,2491,3125
"9052",9052,62,509,780,573,"0424",3828,2675,1153
"9053",9053,109,384,736,504,"0425",964,404,560
"9054",9054,95,430,746,533,"0426",2366,1414,952
"9055",9055,130,1416,2267,1563,"0427",3399,2079,1320
"9056",9056,0,0,0,0,"0428",3612,2179,1433
"9057",9057,243,809,1715,1068,"0429",2409,923,1486
"9058",9058,369,1038,2372,1428,"0434",3965,2961,1004
"9059",9059,128,272,712,407,"0436",965,641,324
"9060",9060,10,100,138,111,"0455",4047,1620,2427
"9061",9061,33,296,478,333,"0456",3151,961,2190
"9062",9062,12,136,241,149,"0463",8762,3473,5289
"9063",9063,49,221,501,275,"0480",7220,3479,3741
"9064",9064,54,317,619,377,"0484",7741,3849,3892
"9065",9065,4,60,99,65,"0488",3475,1979,1496
"9066",9066,17,140,256,163,"0489",5323,2942,2381
"9067",9067,283,391,1172,682,"0490",3464,1890,1574
"9068",9068,282,559,1529,849,"0491",7072,3587,3485
"9069",9069,42,488,653,534,"0101",2597,1218,1379
"9070",9070,58,340,496,399,"0102",2379,593,1786
"9071",9071,324,826,1777,1161,"0103",2078,894,1184
"9072",9072,37,177,237,217,"0104",1431,824,607
"9073",9073,88,371,661,460,"0205",2085,1172,913
"9074",9074,523,494,1734,1031,"0206",2958,1372,1586
"9075",9075,499,250,1528,759,"0207",2407,1371,1036
"9076",9076,332,229,1141,564,"0208",655,474,181
"9077",9077,77,270,592,350,"0209",506,445,61
"9078",9078,639,982,2532,1633,"0310",944,651,293
"9079",9079,867,721,3172,1606,"0311",2280,1729,551
"9080",9080,22,76,116,99,"0312",2705,2006,699
"9081",9081,727,706,3020,1454,"0313",4148,2727,1421
"9082",9082,548,357,2119,917,"0414",2951,1904,1047
"9083",9083,32,33,166,67,"0415",4530,3119,1411
"9084",9084,71,58,297,133,"0416",3117,1704,1413
"9085",9085,2,1,8,3,"0101",1355,588,767
"9086",9086,0,0,0,0,"0201",579,192,387
"9087",9087,337,554,1961,938,"0202",670,422,248
"9088",9088,16,112,157,128,"0301",1414,642,772
"9089",9089,433,353,1796,793,"0401",1584,307,1277
"9090",9090,583,546,2419,1149,"0001",2115,1628,487
"9091",9091,56,160,246,219,"0002",4177,2828,1349
"9092",9092,326,389,1609,724,"0003",857,739,118
"9093",9093,604,851,2332,1477,"0004",328,288,40
"9094",9094,903,1464,3627,2393,"0005",2330,1790,540
"9095",9095,34,156,278,190,"0006",2554,1798,756
"9096",9096,261,783,1486,1058,"0007A",857,678,179
"9097",9097,1386,1138,5035,2546,"0007B",907,639,268
"9098",9098,445,560,2278,1012,"0008",2571,2098,473
"9099",9099,3,19,38,22,"0009",2480,2105,375
"9100",9100,3,44,67,48,"0010",616,513,103
"9101",9101,204,1312,2226,1526,"0011",753,649,104
"9102",9102,282,1805,3281,2103,"0012",2060,1704,356
"9103",9103,95,959,1567,1061,"0013",1660,1023,637
"9104",9104,111,863,1433,979,"0014",2872,1747,1125
"9105",9105,121,479,1003,605,"0015",1395,1210,185
"9106",9106,312,2200,3789,2528,"0016",2885,2395,490
"9107",9107,115,1057,1630,1185,"0017",3331,2836,495
"9108",9108,183,1566,2529,1764,"0018",1764,929,835
"9109",9109,147,1015,1724,1175,"0019",612,520,92
"9110",9110,76,535,918,614,"0020",1351,1170,181
"9111",9111,268,891,1925,1168,"0022",1318,1094,224
"9112",9112,414,1795,3713,2235,"0023",2410,1944,466
"9113",9113,210,1830,3003,2056,"0024",4625,3343,1282
"9114",9114,131,922,1534,1067,"0025",114,110,4
"9115",9115,158,1155,2076,1323,"0027",4894,4009,885
"9116",9116,161,1057,1787,1232,"01-1",3674,3110,564
"9117",9117,414,2040,3692,2467,"01-2",2772,2430,342
"9118",9118,114,789,1292,906,"01-3",2363,2084,279
"9119",9119,156,107,620,274,"01-4",790,664,126
"9120",9120,231,326,927,567,"02-1",560,471,89
"9121",9121,292,463,1243,767,"02-2",4688,3564,1124
"9122",9122,365,293,1572,669,"02-3",3698,2892,806
"9123",9123,641,599,2598,1268,"03-1",1360,1168,192
"9124",9124,84,52,352,142,"03-2",3309,3008,301
"9125",9125,676,561,2467,1268,"03-3",4192,3253,939
"9126",9126,638,735,2934,1406,"04-1",907,780,127
"9127",9127,165,231,783,404,"04-2",2993,2568,425
"9128",9128,270,503,1220,780,"04-3",4326,3346,980
"9129",9129,61,247,422,309,"04-4",919,767,152
"9130",9130,156,234,739,396,"0101",1333,496,837
"9131",9131,323,381,1802,707,"0202",1420,539,881
"9132",9132,210,655,1399,880,"0303",673,228,445
"9133",9133,17,79,133,97,"0305",715,192,523
"9134",9134,53,244,461,300,"0404",556,295,261
"9135",9135,89,137,448,232,"0406",776,227,549
"9136",9136,497,2138,4033,2670,"0005",3317,2703,614
"9137",9137,652,1033,2915,1707,"0006",213,168,45
"9138",9138,172,799,1416,980,"0007",158,130,28
"9139",9139,681,2142,3948,2862,"0010",481,405,76
"9140",9140,134,1097,1629,1244,"0016",269,248,21
"9141",9141,187,970,1655,1173,"0020",265,235,30
"9142",9142,155,955,1474,1116,"0022",3602,3074,528
"9143",9143,785,1602,4071,2421,"0023",2709,2017,692
"9144",9144,121,418,819,547,"0024",2634,1780,854
"9145",9145,98,1197,1655,1305,"0001",2121,113,2008
"9146",9146,35,307,501,344,"0002",1866,129,1737
"9147",9147,473,1358,2563,1846,"0003",2549,350,2199
"9148",9148,108,211,525,322,"0004",2428,63,2365
"9149",9149,278,426,1255,714,"001A",107,5,102
"9150",9150,354,290,1516,664,"001B",85,4,81
"9151",9151,756,2333,4458,3138,"002A",436,27,409
"9152",9152,338,173,1315,515,"0001",654,76,578
"9153",9153,129,62,591,195,"0002",1929,76,1853
"9154",9154,255,145,699,408,"0003",1914,35,1879
"9155",9155,1274,1451,4328,2799,"0004",1075,149,926
"9156",9156,311,895,1724,1232,"001A",666,60,606
"9157",9157,268,1207,2004,1496,"004A",681,46,635
"9158",9158,735,709,2428,1483,NA,NA,NA,NA
"9159",9159,5,11,21,16,NA,NA,NA,NA
"9160",9160,399,1130,2046,1555,NA,NA,NA,NA
"9161",9161,138,302,594,448,NA,NA,NA,NA
"9162",9162,162,360,695,525,NA,NA,NA,NA
"9163",9163,633,1770,3032,2451,NA,NA,NA,NA
"9164",9164,189,225,648,418,NA,NA,NA,NA
"9165",9165,979,579,2938,1586,NA,NA,NA,NA
"9166",9166,150,388,737,543,NA,NA,NA,NA
"9167",9167,117,361,727,479,NA,NA,NA,NA
"9168",9168,573,2134,4019,2732,NA,NA,NA,NA
"9169",9169,922,661,2850,1632,NA,NA,NA,NA
"9170",9170,244,716,1410,971,NA,NA,NA,NA
"9171",9171,0,2,3,2,NA,NA,NA,NA
"9172",9172,513,2280,3844,2816,NA,NA,NA,NA
"9173",9173,17,49,97,66,NA,NA,NA,NA
"9174",9174,429,893,1943,1335,NA,NA,NA,NA
"9175",9175,941,1054,3149,2013,NA,NA,NA,NA
"9176",9176,63,154,324,220,NA,NA,NA,NA
"9177",9177,172,314,808,488,NA,NA,NA,NA
"9178",9178,107,498,866,609,NA,NA,NA,NA
"9179",9179,340,607,1415,967,NA,NA,NA,NA
"9180",9180,355,2232,3704,2617,NA,NA,NA,NA
"9181",9181,340,716,1748,1075,NA,NA,NA,NA
"9182",9182,357,1723,2913,2102,NA,NA,NA,NA
"9183",9183,61,294,488,361,NA,NA,NA,NA
"9184",9184,1602,41,4145,1653,NA,NA,NA,NA
"9185",9185,696,204,1784,920,NA,NA,NA,NA
"9186",9186,248,974,1725,1240,NA,NA,NA,NA
"9187",9187,237,466,1090,717,NA,NA,NA,NA
"9188",9188,66,113,273,185,NA,NA,NA,NA
"9189",9189,64,186,358,253,NA,NA,NA,NA
"9190",9190,0,0,0,0,NA,NA,NA,NA
"9191",9191,552,1534,2713,2113,NA,NA,NA,NA
"9192",9192,892,622,2777,1536,NA,NA,NA,NA
"9193",9193,642,1608,2763,2276,NA,NA,NA,NA
"9194",9194,216,1065,1908,1306,NA,NA,NA,NA
"9195",9195,215,440,1303,674,NA,NA,NA,NA
"9196",9196,63,59,299,131,NA,NA,NA,NA
"9197",9197,100,764,1435,881,NA,NA,NA,NA
"9198",9198,27,203,393,233,NA,NA,NA,NA
"9199",9199,113,504,1137,630,NA,NA,NA,NA
"9200",9200,18,142,275,163,NA,NA,NA,NA
"9201",9201,12,64,111,76,NA,NA,NA,NA
"9202",9202,320,598,1288,932,NA,NA,NA,NA
"9203",9203,802,446,2141,1266,NA,NA,NA,NA
"9204",9204,154,661,1079,826,NA,NA,NA,NA
"9205",9205,163,536,983,713,NA,NA,NA,NA
"9206",9206,36,11,98,47,NA,NA,NA,NA
"9207",9207,26,38,101,67,NA,NA,NA,NA
"9208",9208,35,65,168,101,NA,NA,NA,NA
"9209",9209,300,1116,1925,1447,NA,NA,NA,NA
"9210",9210,494,1401,2547,1943,NA,NA,NA,NA
"9211",9211,147,995,1475,1163,NA,NA,NA,NA
"9212",9212,328,834,1660,1180,NA,NA,NA,NA
"9213",9213,170,747,1247,947,NA,NA,NA,NA
"9214",9214,150,803,1228,961,NA,NA,NA,NA
"9215",9215,205,1306,1920,1535,NA,NA,NA,NA
"9216",9216,345,861,1851,1228,NA,NA,NA,NA
"9217",9217,158,791,1248,963,NA,NA,NA,NA
"9218",9218,178,1165,1683,1366,NA,NA,NA,NA
"9219",9219,140,301,687,453,NA,NA,NA,NA
"9220",9220,110,284,555,403,NA,NA,NA,NA
"9221",9221,308,129,1133,451,NA,NA,NA,NA
"9222",9222,635,273,2265,949,NA,NA,NA,NA
"9223",9223,328,141,939,482,NA,NA,NA,NA
"9224",9224,444,223,1786,686,NA,NA,NA,NA
"9225",9225,744,423,2774,1217,NA,NA,NA,NA
"9226",9226,841,463,3270,1356,NA,NA,NA,NA
"9227",9227,991,548,4045,1576,NA,NA,NA,NA
"9228",9228,773,425,3351,1234,NA,NA,NA,NA
"9229",9229,548,312,2553,909,NA,NA,NA,NA
"9230",9230,332,178,1496,544,NA,NA,NA,NA
"9231",9231,98,131,350,258,NA,NA,NA,NA
"9232",9232,388,234,1748,640,NA,NA,NA,NA
"9233",9233,335,153,1216,502,NA,NA,NA,NA
"9234",9234,531,305,2006,869,NA,NA,NA,NA
"9235",9235,260,167,884,434,NA,NA,NA,NA
"9236",9236,7,4,26,12,NA,NA,NA,NA
"9237",9237,466,254,2004,740,NA,NA,NA,NA
"9238",9238,715,346,2293,1095,NA,NA,NA,NA
"9239",9239,541,291,1547,843,NA,NA,NA,NA
"9240",9240,418,189,1356,619,NA,NA,NA,NA
"9241",9241,420,216,1019,644,NA,NA,NA,NA
"9242",9242,392,202,1209,606,NA,NA,NA,NA
"9243",9243,241,148,793,405,NA,NA,NA,NA
"9244",9244,643,405,2134,1069,NA,NA,NA,NA
"9245",9245,168,216,606,413,NA,NA,NA,NA
"9246",9246,68,38,261,109,NA,NA,NA,NA
"9247",9247,664,432,1833,1114,NA,NA,NA,NA
"9248",9248,707,460,2312,1185,NA,NA,NA,NA
"9249",9249,0,0,2,0,NA,NA,NA,NA
"9250",9250,19,11,60,30,NA,NA,NA,NA
"9251",9251,188,68,586,264,NA,NA,NA,NA
"9252",9252,747,442,2535,1218,NA,NA,NA,NA
"9253",9253,813,583,2234,1421,NA,NA,NA,NA
"9254",9254,490,235,1970,741,NA,NA,NA,NA
"9255",9255,635,350,2236,1005,NA,NA,NA,NA
"9256",9256,87,78,342,170,NA,NA,NA,NA
"9257",9257,672,447,1861,1142,NA,NA,NA,NA
"9258",9258,625,396,2074,1046,NA,NA,NA,NA
"9259",9259,600,389,1953,1004,NA,NA,NA,NA
"9260",9260,258,157,873,422,NA,NA,NA,NA
"9261",9261,13,7,42,20,NA,NA,NA,NA
"9262",9262,12,25,54,37,NA,NA,NA,NA
"9263",9263,305,229,887,551,NA,NA,NA,NA
"9264",9264,1185,554,3077,1782,NA,NA,NA,NA
"9265",9265,174,73,416,251,NA,NA,NA,NA
"9266",9266,570,279,1720,865,NA,NA,NA,NA
"9267",9267,370,181,1386,573,NA,NA,NA,NA
"9268",9268,787,740,2252,1550,NA,NA,NA,NA
"9269",9269,535,473,1518,1024,NA,NA,NA,NA
"9270",9270,818,553,2387,1400,NA,NA,NA,NA
"9271",9271,1019,635,2592,1679,NA,NA,NA,NA
"9272",9272,1340,1056,3659,2443,NA,NA,NA,NA
"9273",9273,920,598,2289,1531,NA,NA,NA,NA
"9274",9274,953,977,3127,1951,NA,NA,NA,NA
"9275",9275,1603,1324,4504,2974,NA,NA,NA,NA
"9276",9276,1508,996,3867,2534,NA,NA,NA,NA
"9277",9277,503,295,1623,815,NA,NA,NA,NA
"9278",9278,307,146,1063,468,NA,NA,NA,NA
"9279",9279,604,396,1688,1023,NA,NA,NA,NA
"9280",9280,867,689,2366,1579,NA,NA,NA,NA
"9281",9281,446,239,1715,721,NA,NA,NA,NA
"9282",9282,527,217,1875,787,NA,NA,NA,NA
"9283",9283,386,190,1365,609,NA,NA,NA,NA
"9284",9284,561,236,1953,818,NA,NA,NA,NA
"9285",9285,558,284,2205,864,NA,NA,NA,NA
"9286",9286,283,134,1136,429,NA,NA,NA,NA
"9287",9287,159,91,759,259,NA,NA,NA,NA
"9288",9288,620,302,2312,951,NA,NA,NA,NA
"9289",9289,307,131,1200,461,NA,NA,NA,NA
"9290",9290,480,229,1706,723,NA,NA,NA,NA
"9291",9291,312,123,1183,452,NA,NA,NA,NA
"9292",9292,180,97,668,286,NA,NA,NA,NA
"9293",9293,192,116,572,318,NA,NA,NA,NA
"9294",9294,1236,681,3916,1954,NA,NA,NA,NA
"9295",9295,963,858,3479,1869,NA,NA,NA,NA
"9296",9296,111,97,498,213,NA,NA,NA,NA
"9297",9297,163,69,558,233,NA,NA,NA,NA
"9298",9298,20,28,80,49,NA,NA,NA,NA
"9299",9299,1250,824,3870,2116,NA,NA,NA,NA
"9300",9300,166,98,614,275,NA,NA,NA,NA
"9301",9301,133,60,516,197,NA,NA,NA,NA
"9302",9302,256,112,1040,378,NA,NA,NA,NA
"9303",9303,141,221,582,364,NA,NA,NA,NA
"9304",9304,663,1679,3365,2377,NA,NA,NA,NA
"9305",9305,453,1293,2747,1767,NA,NA,NA,NA
"9306",9306,258,1778,2763,2047,NA,NA,NA,NA
"9307",9307,361,189,934,558,NA,NA,NA,NA
"9308",9308,1085,966,3485,2091,NA,NA,NA,NA
"9309",9309,246,1495,2327,1762,NA,NA,NA,NA
"9310",9310,312,1016,2153,1351,NA,NA,NA,NA
"9311",9311,159,1350,2081,1529,NA,NA,NA,NA
"9312",9312,603,902,2719,1528,NA,NA,NA,NA
"9313",9313,270,799,1804,1083,NA,NA,NA,NA
"9314",9314,143,238,656,386,NA,NA,NA,NA
"9315",9315,20,636,911,658,NA,NA,NA,NA
"9316",9316,44,434,735,480,NA,NA,NA,NA
"9317",9317,46,499,911,550,NA,NA,NA,NA
"9318",9318,58,590,953,649,NA,NA,NA,NA
"9319",9319,38,179,274,223,NA,NA,NA,NA
"9320",9320,225,524,1181,776,NA,NA,NA,NA
"9321",9321,962,2547,5755,3605,NA,NA,NA,NA
"9322",9322,701,1581,3850,2337,NA,NA,NA,NA
"9323",9323,82,594,1013,690,NA,NA,NA,NA
"9324",9324,9,30,75,39,NA,NA,NA,NA
"9325",9325,630,1914,4161,2611,NA,NA,NA,NA
"9326",9326,921,2254,5484,3241,NA,NA,NA,NA
"9327",9327,183,183,810,371,NA,NA,NA,NA
"9328",9328,668,977,3530,1707,NA,NA,NA,NA
"9329",9329,608,1058,3424,1704,NA,NA,NA,NA
"9330",9330,430,584,2520,1055,NA,NA,NA,NA
"9331",9331,68,439,773,517,NA,NA,NA,NA
"9332",9332,513,2182,4581,2756,NA,NA,NA,NA
"9333",9333,391,1679,3822,2108,NA,NA,NA,NA
"9334",9334,2,21,39,23,NA,NA,NA,NA
"9335",9335,72,177,503,252,NA,NA,NA,NA
"9336",9336,11,16,30,28,NA,NA,NA,NA
"9337",9337,92,147,576,250,NA,NA,NA,NA
"9338",9338,17,3,65,26,NA,NA,NA,NA
"9339",9339,159,305,1049,478,NA,NA,NA,NA
"9340",9340,623,983,3726,1657,NA,NA,NA,NA
"9341",9341,589,377,2470,989,NA,NA,NA,NA
"9342",9342,160,262,1089,441,NA,NA,NA,NA
"9343",9343,203,61,604,271,NA,NA,NA,NA
"9344",9344,31,101,226,132,NA,NA,NA,NA
"9345",9345,177,139,923,327,NA,NA,NA,NA
"9346",9346,315,2460,4340,2822,NA,NA,NA,NA
"9347",9347,140,1063,2019,1220,NA,NA,NA,NA
"9348",9348,570,274,2710,868,NA,NA,NA,NA
"9349",9349,449,1139,2685,1641,NA,NA,NA,NA
"9350",9350,132,367,872,511,NA,NA,NA,NA
"9351",9351,639,1468,3776,2156,NA,NA,NA,NA
"9352",9352,519,1517,3070,2093,NA,NA,NA,NA
"9353",9353,853,1306,4805,2230,NA,NA,NA,NA
"9354",9354,638,1609,3797,2296,NA,NA,NA,NA
"9355",9355,59,458,738,523,NA,NA,NA,NA
"9356",9356,98,450,1154,556,NA,NA,NA,NA
"9357",9357,80,434,731,526,NA,NA,NA,NA
"9358",9358,104,207,530,322,NA,NA,NA,NA
"9359",9359,272,1047,2204,1331,NA,NA,NA,NA
"9360",9360,14,65,140,79,NA,NA,NA,NA
"9361",9361,315,690,1985,1015,NA,NA,NA,NA
"9362",9362,149,537,1632,693,NA,NA,NA,NA
"9363",9363,206,1185,2210,1406,NA,NA,NA,NA
"9364",9364,113,71,562,188,NA,NA,NA,NA
"9365",9365,32,19,120,54,NA,NA,NA,NA
"9366",9366,269,233,1023,509,NA,NA,NA,NA
"9367",9367,492,325,1813,827,NA,NA,NA,NA
"9368",9368,245,153,865,406,NA,NA,NA,NA
"9369",9369,121,123,478,245,NA,NA,NA,NA
"9370",9370,70,47,290,119,NA,NA,NA,NA
"9371",9371,73,54,346,130,NA,NA,NA,NA
"9372",9372,272,193,1069,471,NA,NA,NA,NA
"9373",9373,43,182,398,227,NA,NA,NA,NA
"9374",9374,13,13,60,28,NA,NA,NA,NA
"9375",9375,26,20,100,46,NA,NA,NA,NA
"9376",9376,327,238,1670,570,NA,NA,NA,NA
"9377",9377,449,280,1559,733,NA,NA,NA,NA
"9378",9378,264,199,1069,469,NA,NA,NA,NA
"9379",9379,146,125,694,273,NA,NA,NA,NA
"9380",9380,153,166,674,320,NA,NA,NA,NA
"9381",9381,595,443,1406,1069,NA,NA,NA,NA
"9382",9382,0,0,0,0,NA,NA,NA,NA
"9383",9383,2499,1021,5284,3616,NA,NA,NA,NA
"9384",9384,1503,840,3270,2399,NA,NA,NA,NA
"9385",9385,1497,1223,3854,2796,NA,NA,NA,NA
"9386",9386,214,153,480,377,NA,NA,NA,NA
"9387",9387,1600,955,4216,2633,NA,NA,NA,NA
"9388",9388,1381,712,3580,2159,NA,NA,NA,NA
"9389",9389,101,48,254,151,NA,NA,NA,NA
"9390",9390,756,615,1860,1409,NA,NA,NA,NA
"9391",9391,1514,961,3728,2549,NA,NA,NA,NA
"9392",9392,230,117,612,355,NA,NA,NA,NA
"9393",9393,314,224,773,554,NA,NA,NA,NA
"9394",9394,1126,763,2929,1954,NA,NA,NA,NA
"9395",9395,2288,922,4793,3288,NA,NA,NA,NA
"9396",9396,2628,1079,5768,3820,NA,NA,NA,NA
"9397",9397,1166,736,2930,1953,NA,NA,NA,NA
"9398",9398,1754,971,4512,2803,NA,NA,NA,NA
"9399",9399,2453,978,4935,3534,NA,NA,NA,NA
"9400",9400,1642,838,3836,2528,NA,NA,NA,NA
"9401",9401,2158,872,4259,3108,NA,NA,NA,NA
"9402",9402,1423,725,3256,2190,NA,NA,NA,NA
"9403",9403,206,107,481,324,NA,NA,NA,NA
"9404",9404,893,648,2244,1572,NA,NA,NA,NA
"9405",9405,1110,830,2626,1993,NA,NA,NA,NA
"9406",9406,1261,516,2672,1820,NA,NA,NA,NA
"9407",9407,1369,671,3106,2101,NA,NA,NA,NA
"9408",9408,1904,1083,4308,3062,NA,NA,NA,NA
"9409",9409,856,496,1935,1387,NA,NA,NA,NA
"9410",9410,409,412,1012,835,NA,NA,NA,NA
"9411",9411,608,464,1447,1099,NA,NA,NA,NA
"9412",9412,1448,746,2963,2238,NA,NA,NA,NA
"9413",9413,1693,934,3643,2668,NA,NA,NA,NA
"9414",9414,361,257,892,637,NA,NA,NA,NA
"9415",9415,266,189,655,468,NA,NA,NA,NA
"9416",9416,41,25,86,67,NA,NA,NA,NA
"9417",9417,1444,1113,3502,2624,NA,NA,NA,NA
"9418",9418,248,252,603,514,NA,NA,NA,NA
"9419",9419,53,41,130,95,NA,NA,NA,NA
"9420",9420,1480,1125,3551,2676,NA,NA,NA,NA
"9421",9421,97,61,203,160,NA,NA,NA,NA
"9422",9422,434,1145,2070,1619,NA,NA,NA,NA
"9423",9423,570,1715,3003,2322,NA,NA,NA,NA
"9424",9424,349,930,1674,1303,NA,NA,NA,NA
"9425",9425,644,1943,3416,2635,NA,NA,NA,NA
"9426",9426,695,1022,2207,1767,NA,NA,NA,NA
"9427",9427,557,443,1351,1034,NA,NA,NA,NA
"9428",9428,93,97,229,193,NA,NA,NA,NA
"9429",9429,1667,1540,4347,3296,NA,NA,NA,NA
"9430",9430,695,709,1894,1440,NA,NA,NA,NA
"9431",9431,886,1583,2916,2514,NA,NA,NA,NA
"9432",9432,831,1604,2852,2477,NA,NA,NA,NA
"9433",9433,21,57,102,80,NA,NA,NA,NA
"9434",9434,1275,1495,3646,2829,NA,NA,NA,NA
"9435",9435,1561,1951,5005,3594,NA,NA,NA,NA
"9436",9436,1442,1353,4013,2871,NA,NA,NA,NA
"9437",9437,863,1197,2652,2127,NA,NA,NA,NA
"9438",9438,516,646,1556,1191,NA,NA,NA,NA
"9439",9439,1559,1566,4203,3216,NA,NA,NA,NA
"9440",9440,51,73,157,126,NA,NA,NA,NA
"9441",9441,544,621,1616,1195,NA,NA,NA,NA
"9442",9442,1100,1109,2879,2255,NA,NA,NA,NA
"9443",9443,719,853,2203,1616,NA,NA,NA,NA
"9444",9444,1184,1207,3121,2439,NA,NA,NA,NA
"9445",9445,1000,1207,3109,2267,NA,NA,NA,NA
"9446",9446,1306,939,3247,2297,NA,NA,NA,NA
"9447",9447,711,985,2177,1742,NA,NA,NA,NA
"9448",9448,701,631,1745,1365,NA,NA,NA,NA
"9449",9449,1737,1474,4269,3298,NA,NA,NA,NA
"9450",9450,1895,1463,4552,3452,NA,NA,NA,NA
"9451",9451,53,48,131,101,NA,NA,NA,NA
"9452",9452,1493,1194,3973,2757,NA,NA,NA,NA
"9453",9453,1618,1424,4311,3128,NA,NA,NA,NA
"9454",9454,948,886,2537,1895,NA,NA,NA,NA
"9455",9455,2227,1456,4745,3753,NA,NA,NA,NA
"9456",9456,278,282,671,570,NA,NA,NA,NA
"9457",9457,1223,732,2477,1992,NA,NA,NA,NA
"9458",9458,271,631,1057,919,NA,NA,NA,NA
"9459",9459,1071,2497,4237,3624,NA,NA,NA,NA
"9460",9460,208,340,738,554,NA,NA,NA,NA
"9461",9461,222,449,884,687,NA,NA,NA,NA
"9462",9462,735,1840,3256,2635,NA,NA,NA,NA
"9463",9463,312,1003,1864,1344,NA,NA,NA,NA
"9464",9464,32,66,141,99,NA,NA,NA,NA
"9465",9465,256,473,921,742,NA,NA,NA,NA
"9466",9466,1480,1437,4163,2984,NA,NA,NA,NA
"9467",9467,452,326,1014,798,NA,NA,NA,NA
"9468",9468,160,146,395,315,NA,NA,NA,NA
"9469",9469,75,66,181,144,NA,NA,NA,NA
"9470",9470,552,492,1357,1075,NA,NA,NA,NA
"9471",9471,11,10,27,21,NA,NA,NA,NA
"9472",9472,655,480,1482,1171,NA,NA,NA,NA
"9473",9473,36,33,89,71,NA,NA,NA,NA
"9474",9474,397,429,1022,848,NA,NA,NA,NA
"9475",9475,980,1137,2627,2152,NA,NA,NA,NA
"9476",9476,242,231,636,482,NA,NA,NA,NA
"9477",9477,1016,822,2486,1881,NA,NA,NA,NA
"9478",9478,941,692,2105,1669,NA,NA,NA,NA
"9479",9479,806,1177,2800,2035,NA,NA,NA,NA
"9480",9480,598,531,1597,1166,NA,NA,NA,NA
"9481",9481,1269,1509,3700,2845,NA,NA,NA,NA
"9482",9482,560,994,1838,1585,NA,NA,NA,NA
"9483",9483,319,464,966,800,NA,NA,NA,NA
"9484",9484,457,803,1486,1286,NA,NA,NA,NA
"9485",9485,2103,1386,4822,3588,NA,NA,NA,NA
"9486",9486,43,36,113,81,NA,NA,NA,NA
"9487",9487,1329,1197,3760,2578,NA,NA,NA,NA
"9488",9488,1139,1154,3080,2362,NA,NA,NA,NA
"9489",9489,822,975,2610,1850,NA,NA,NA,NA
"9490",9490,846,1397,2971,2289,NA,NA,NA,NA
"9491",9491,1702,1533,4054,3315,NA,NA,NA,NA
"9492",9492,877,1781,3482,2709,NA,NA,NA,NA
"9493",9493,27,25,79,54,NA,NA,NA,NA
"9494",9494,1053,1790,3265,2862,NA,NA,NA,NA
"9495",9495,1256,1121,3074,2446,NA,NA,NA,NA
"9496",9496,0,0,0,0,NA,NA,NA,NA
"9497",9497,461,823,1623,1303,NA,NA,NA,NA
"9498",9498,950,1690,3353,2691,NA,NA,NA,NA
"9499",9499,987,1763,3178,2769,NA,NA,NA,NA
"9500",9500,1071,1773,3204,2864,NA,NA,NA,NA
"9501",9501,68,167,292,241,NA,NA,NA,NA
"9502",9502,650,1173,2080,1837,NA,NA,NA,NA
"9503",9503,676,1212,2158,1902,NA,NA,NA,NA
"9504",9504,1639,1038,3503,2750,NA,NA,NA,NA
"9505",9505,412,252,868,677,NA,NA,NA,NA
"9506",9506,1773,1483,4751,3359,NA,NA,NA,NA
"9507",9507,1747,1481,4727,3329,NA,NA,NA,NA
"9508",9508,657,545,1709,1236,NA,NA,NA,NA
"9509",9509,73,143,314,220,NA,NA,NA,NA
"9510",9510,918,1734,3846,2722,NA,NA,NA,NA
"9511",9511,586,1341,2730,1964,NA,NA,NA,NA
"9512",9512,273,554,1202,842,NA,NA,NA,NA
"9513",9513,536,1620,2930,2192,NA,NA,NA,NA
"9514",9514,362,921,1801,1299,NA,NA,NA,NA
"9515",9515,4,5,12,9,NA,NA,NA,NA
"9516",9516,291,235,709,540,NA,NA,NA,NA
"9517",9517,1296,1055,3177,2409,NA,NA,NA,NA
"9518",9518,390,448,1138,862,NA,NA,NA,NA
"9519",9519,1726,1420,4263,3245,NA,NA,NA,NA
"9520",9520,1440,1663,4030,3154,NA,NA,NA,NA
"9521",9521,147,272,682,427,NA,NA,NA,NA
"9522",9522,355,426,1061,798,NA,NA,NA,NA
"9523",9523,810,1077,2729,1931,NA,NA,NA,NA
"9524",9524,780,1196,2689,2014,NA,NA,NA,NA
"9525",9525,814,694,2416,1539,NA,NA,NA,NA
"9526",9526,144,128,377,280,NA,NA,NA,NA
"9527",9527,1715,1717,4613,3514,NA,NA,NA,NA
"9528",9528,186,670,1162,872,NA,NA,NA,NA
"9529",9529,371,534,1258,916,NA,NA,NA,NA
"9530",9530,2175,1883,5428,4148,NA,NA,NA,NA
"9531",9531,598,508,2041,1134,NA,NA,NA,NA
"9532",9532,423,371,1125,819,NA,NA,NA,NA
"9533",9533,704,967,2374,1711,NA,NA,NA,NA
"9534",9534,76,109,260,188,NA,NA,NA,NA
"9535",9535,178,239,594,429,NA,NA,NA,NA
"9536",9536,360,503,1233,891,NA,NA,NA,NA
"9537",9537,1306,1309,3232,2658,NA,NA,NA,NA
"9538",9538,1424,1085,3383,2569,NA,NA,NA,NA
"9539",9539,883,658,2074,1570,NA,NA,NA,NA
"9540",9540,463,479,1257,970,NA,NA,NA,NA
"9541",9541,52,44,128,98,NA,NA,NA,NA
"9542",9542,1242,1105,3129,2413,NA,NA,NA,NA
"9543",9543,1364,1077,3262,2481,NA,NA,NA,NA
"9544",9544,1774,1602,4567,3444,NA,NA,NA,NA
"9545",9545,1634,1156,4022,2869,NA,NA,NA,NA
"9546",9546,951,1836,3816,2804,NA,NA,NA,NA
"9547",9547,710,669,2353,1391,NA,NA,NA,NA
"9548",9548,478,862,2017,1357,NA,NA,NA,NA
"9549",9549,210,570,1068,785,NA,NA,NA,NA
"9550",9550,420,1785,3112,2220,NA,NA,NA,NA
"9551",9551,662,1028,2487,1704,NA,NA,NA,NA
"9552",9552,658,1602,3114,2284,NA,NA,NA,NA
"9553",9553,269,1612,2451,1897,NA,NA,NA,NA
"9554",9554,337,1724,2834,2083,NA,NA,NA,NA
"9555",9555,488,1942,3569,2453,NA,NA,NA,NA
"9556",9556,335,1633,2906,1986,NA,NA,NA,NA
"9557",9557,520,1950,3234,2491,NA,NA,NA,NA
"9558",9558,312,1250,2029,1577,NA,NA,NA,NA
"9559",9559,100,481,1003,587,NA,NA,NA,NA
"9560",9560,39,184,461,227,NA,NA,NA,NA
"9561",9561,37,424,744,463,NA,NA,NA,NA
"9562",9562,73,480,1080,555,NA,NA,NA,NA
"9563",9563,109,184,722,294,NA,NA,NA,NA
"9564",9564,122,700,1053,832,NA,NA,NA,NA
"9565",9565,391,1561,2910,1986,NA,NA,NA,NA
"9566",9566,133,834,1275,978,NA,NA,NA,NA
"9567",9567,124,656,1032,789,NA,NA,NA,NA
"9568",9568,209,1167,1916,1402,NA,NA,NA,NA
"9569",9569,309,1181,2307,1539,NA,NA,NA,NA
"9570",9570,393,1656,2750,2075,NA,NA,NA,NA
"9571",9571,210,1115,1754,1340,NA,NA,NA,NA
"9572",9572,190,1565,2400,1773,NA,NA,NA,NA
"9573",9573,50,400,577,453,NA,NA,NA,NA
"9574",9574,53,439,671,497,NA,NA,NA,NA
"9575",9575,139,1046,1790,1203,NA,NA,NA,NA
"9576",9576,76,402,673,483,NA,NA,NA,NA
"9577",9577,95,436,805,537,NA,NA,NA,NA
"9578",9578,141,998,1579,1153,NA,NA,NA,NA
"9579",9579,226,1531,2467,1777,NA,NA,NA,NA
"9580",9580,249,1851,2802,2128,NA,NA,NA,NA
"9581",9581,100,537,1016,644,NA,NA,NA,NA
"9582",9582,59,282,492,346,NA,NA,NA,NA
"9583",9583,120,926,1379,1061,NA,NA,NA,NA
"9584",9584,130,695,1119,840,NA,NA,NA,NA
"9585",9585,211,1287,2232,1510,NA,NA,NA,NA
"9586",9586,278,1106,2123,1402,NA,NA,NA,NA
"9587",9587,105,610,1039,729,NA,NA,NA,NA
"9588",9588,325,1882,3233,2251,NA,NA,NA,NA
"9589",9589,233,887,1711,1136,NA,NA,NA,NA
"9590",9590,54,279,525,338,NA,NA,NA,NA
"9591",9591,248,1003,1935,1275,NA,NA,NA,NA
"9592",9592,341,1866,3089,2227,NA,NA,NA,NA
"9593",9593,259,1687,2599,1959,NA,NA,NA,NA
"9594",9594,220,1423,2256,1658,NA,NA,NA,NA
"9595",9595,45,506,733,554,NA,NA,NA,NA
"9596",9596,35,310,475,349,NA,NA,NA,NA
"9597",9597,424,2260,4062,2721,NA,NA,NA,NA
"9598",9598,452,1733,3180,2205,NA,NA,NA,NA
"9599",9599,128,771,1210,908,NA,NA,NA,NA
"9600",9600,431,2064,3220,2506,NA,NA,NA,NA
"9601",9601,446,1983,4037,2466,NA,NA,NA,NA
"9602",9602,69,518,825,589,NA,NA,NA,NA
"9603",9603,267,1648,2635,1932,NA,NA,NA,NA
"9604",9604,337,1851,3199,2217,NA,NA,NA,NA
"9605",9605,55,429,785,489,NA,NA,NA,NA
"9606",9606,87,640,1182,739,NA,NA,NA,NA
"9607",9607,96,547,1072,653,NA,NA,NA,NA
"9608",9608,51,279,569,342,NA,NA,NA,NA
"9609",9609,59,162,433,224,NA,NA,NA,NA
"9610",9610,50,327,549,380,NA,NA,NA,NA
"9611",9611,77,219,586,304,NA,NA,NA,NA
"9612",9612,269,1758,2854,2064,NA,NA,NA,NA
"9613",9613,17,151,209,169,NA,NA,NA,NA
"9614",9614,9,102,132,115,NA,NA,NA,NA
"9615",9615,30,350,537,382,NA,NA,NA,NA
"9616",9616,29,399,589,433,NA,NA,NA,NA
"9617",9617,228,1990,3077,2261,NA,NA,NA,NA
"9618",9618,229,1220,2171,1492,NA,NA,NA,NA
"9619",9619,223,1140,2141,1381,NA,NA,NA,NA
"9620",9620,449,478,1871,934,NA,NA,NA,NA
"9621",9621,342,398,1534,743,NA,NA,NA,NA
"9622",9622,457,631,2247,1097,NA,NA,NA,NA
"9623",9623,365,327,1780,692,NA,NA,NA,NA
"9624",9624,27,37,110,64,NA,NA,NA,NA
"9625",9625,31,29,127,60,NA,NA,NA,NA
"9626",9626,155,133,579,288,NA,NA,NA,NA
"9627",9627,222,114,755,339,NA,NA,NA,NA
"9628",9628,756,330,1811,1116,NA,NA,NA,NA
"9629",9629,823,345,2155,1193,NA,NA,NA,NA
"9630",9630,356,348,1335,718,NA,NA,NA,NA
"9631",9631,420,181,1216,620,NA,NA,NA,NA
"9632",9632,287,172,777,477,NA,NA,NA,NA
